WTZXXXXXXXXXXXXXXXXXXXXXXXXXXXXXXXXXXXXXXXXXXXXXXXXXXXXXXXXXX
XTTTTTXTTTTTTTTTTTTTTTXTTTTTXTTTTTTTTTTTXTXTTTTTTTTTTTTTTTTTX
XTXXXTXTXXXTXXXXXXXXXTXTXXXTXTXTXXXXXXXTXTXTXTXXXXXXXXXXXXXTX
XTXTTTXTXTXTXTTTTTTTXTTTXTXTXTXTXTTTTTXTXTTTXTXTTTTTTTTTTTXTX
XTXXXXXTXTXTXTXXXXXTXXXXXTXTXTXTXXXTXXXTXXXXXTXTXXXXXXXXXTXTX
XTTTTTXTXTXTXTTTTTXTTTTTTTXTXTXTXTTTXTTTXTTTTTXTXTTTTTTTXTXTX
XTXXXTXTXTXTXXXXXXXXXXXXXTXTXTXTXTXXXTXXXTXXXTXTXTXXXXXTXTXTX
XTXTXTXTXTXTXTTTTTTTTTTTXTXTXTXTXTTTTTTTTTXTTTXTXTTTTTXTXTXTX
XTXTXTXTXTXTXTXXXXXXXXXTXTXTXTXTXTXXXXXXXXXXXXXTXXXXXXXTXTXTX
XTXTXTXTXTXTXTXTXTTTTTXTXTXTXTXTXTXTTTTTTTTTTTTTTTTTTTTTXTXTX
XTXTXTXTXTXTXTXTXTXTXXXTXTXTXTXTXTXTXXXXXXXXXXXXXXXXXXXXXTXTX
XTTTXTXTXTXTXTXTTTXTTTTTTTXTXTXTXTXTTTTTTTXTTTTTTTTTTTTTXTXTX
XXXXXTXTXTXTXTXXXXXXXXXXXXXTXTXTXTXXXXXXXTXTXXXXXXXXXXXTXTXTX
XTTTTTXTTTXTXTXTTTTTTTTTTTTTXTXTXTTTTTTTXTXTXTTTTTTTTTXTXTXTX
XTXXXTXTXXXTXTXTXXXXXXXXXXXXXXXTXXXXXXXXXTXTXTXTXXXXXTXTXTXTX
XTXTXTXTXTTTXTTTTTTTTTTTTTTTTTXTTTTTTTTTTTXTXTXTXTTTXTXTTTXTX
XTXTXTXTXTXTXXXXXXXXXXXXXXXXXTXXXXXXXXXXXXXTXTXTXTXTXTXXXXXTX
XTXTXTXTXTXTXTTTTTTTTTTTTTTTXTTTTTTTTTTTTTTTXTXTXTXTXTXTTTXTX
XTXTXTXTXTXTXTXXXXXXXXXXXXXTXXXXXXXXXXXXXXXXXTXTXTXTXTXTXTXTX
XTXTTTXTXTXTXTXTTTTTTTTTTTXTXTTTTTTTTTTTTTTTXTXTXTXTXTXTXTXTX
XTXXXXXTXTXTXTXXXXXXXTXTXTXTXXXXXXXXXXXXXTXXXTXTXTXXXTXTXTXTX
XTTTTTTTXTXTXTTTTTTTXTXTXTXTTTTTTTTTTTTTXTTTTTXTXTTTTTXTXTXTX
XXXXXXXXXTXTXXXXXXXTXXXTXTXXXXXXXXXXXXXTXXXXXXXTXXXXXTXTXTXTX
XTTTTTTTTTXTXTTTTTXTTTTTXTTTTTTTTTTTTTXTTTXTTTXTTTTTXTXTXTTTX
XTXXXXXXXXXTXTXXXTXTXXXXXXXXXXXXXTXXXXXXXTXTXTXXXXXTXTXTXXXXX
XTXTXTTTTTXTXTXTXTXTXTTTXTTTTTTTXTXTTTTTTTXTXTTTTTTTXTXTXTTTX
XTXTXTXTXXXTXTXTXTXTXTXTXXXXXXXTXTXTXXXXXXXTXXXXXXXXXTXTXTXTX
XTXTXTXTTTTTXTTTXTXTXTXTTTTTTTXTTTXTXTTTTTXTXTTTTTTTTTXTXTXTX
XTXTXTXXXXXXXXXXXTXTXTXXXXXXXTXXXXXTXTXTXTXTXXXXXXXXXXXTXTXTX
XTXTTTTTTTTTTTTTTTXTXTXTTTTTXTTTTTTTXTXTXTXTXTTTTTTTTTTTXTXTX
XTXXXXXXXXXXXXXXXXXTXTXTXXXTXXXXXXXXXXXTXTXTXTXXXXXXXXXXXTXTX
XTTTTTTTTTTTTTTTTTTTXTXTTTXTTTXTTTTTTTTTXTTTXTXTTTTTTTTTTTXTX
XTXXXXXXXXXXXXXXXXXXXTXXXTXTXTXTXXXXXXXXXXXXXTXTXXXXXXXXXTXTX
XTXTTTTTTTTTTTTTXTTTTTXTTTXTXTXTTTTTXTTTTTTTTTXTTTTTTTTTXTXTX
XTXTXXXXXXXXXTXTXTXXXXXXXTXTXTXXXXXTXTXXXXXXXXXXXXXXXXXTXTXTX
XTXTXTTTTTTTXTXTXTTTTTTTXTXTXTTTTTTTXTXTTTXTTTTTTTTTTTTTXTXT3
XTXTXXXTXXXTXTXXXXXXXXXTXTXTXXXXXXXTXTXXXTXTXXXXXXXXXXXXXTXXX
XTXTTTTTXTTTXTTTTTTTTTXTXTXTXTTTTTXTXTXTTTXTXTTTTTTTTTTTXTTTX
XTXXXXXXXXXXXXXXXXXXXTXTXTXTXTXXXTXTXTXTXXXTXTXXXXXXXXXTXXXTX
XTXTTTTTTTTTTTTTTTTTTTXTXTXTXTTTXTTTXTXTTTTTXTTTTTTTTTXTTTXTX
XTXTXXXXXXXXXXXXXXXXXTXTXTXTXXXTXXXXXTXTXXXXXXXXXXXXXXXXXTXTX
XTXTXTTTXTTTTTTTTTXTXTXTXTXTXTXTTTXTTTXTXTTTTTTTTTTTTTTTXTXTX
XTXTXTXTXTXXXTXXXTXTXTXTXTXTXTXXXTXTXXXTXTXXXXXXXXXXXXXTXTXTX
XTXTXTXTTTXTXTXTXTXTXTXTXTXTXTTTXTXTXTXTXTXTTTXTTTXTTTTTTTXTX
XTXTXXXXXTXTXTXTXTXTXTXTXTXTXTXTXTXTXTXTXTXTXXXTXTXTXXXXXXXTX
XTXTTTTTXTXTXTXTXTXTXTXTXTXTXTXTXTXTXTXTTTXTTTTTXTTTTTXTTTTTX
XTXTXXXTXTXTXTXTXTXTXTXTXTXTXTXXXTXTXTXTXXXXXXXXXXXXXXXTXXXTX
XTXTTTXTXTTTXTXTXTXTXTXTXTXTXTTTTTXTXTTTXTTTTTTTTTTTTTTTXTTTX
XTXXXXXTXXXTXTXTXTXTXTXTXTXTXXXXXXXTXTXXXTXTXXXXXXXXXXXXXXXXX
XTTTXTTTXTTTXTXTXTXTXTXTXTXTTTTTTTXTXTTTXTXTXTTTTTTTTTTTTTTTX
XXXTXTXXXTXXXTXTXTXTXTXTXXXXXXXXXTXTXXXTXTXXXTXXXXXXXXXXXXXTX
XTXTXTXTTTTTXTXTTTTTXTXTXTTTTTTTTTXTXTTTXTTTTTTTTTTTTTTTTTXTX
XTXTXTXXXXXXXTXXXXXXXTXTXTXXXXXXXTXTXXXXXXXXXXXXXXXXXXXXXXXTX
XTXTXTTTTTXTTTXTTTTTTTXTXTXTXTTTTTXTTTTTTTTTTTTTTTTTTTTTTTTTX
XTXTXXXXXTXTXXXTXXXXXXXTXTXTXTXXXXXXXXXXXXXXXXXXXXXXXXXXXXXTX
XTXTTTTTTTXTXTTTXTTTXTTTXTXTTTXTTTTTTTTTTTXTTTTTTTTTTTTTTTXTX
XTXXXXXXXXXTXTXXXTXTXTXXXTXTXXXTXXXTXXXXXXXTXXXXXXXTXXXXXTXTX
XTXTTTTTTTTTXTTTTTXTXTXTTTXTXTTTXTXTTTTTXTTTXTTTTTXTXTTTTTXTX
XTXTXXXXXXXTXTXXXXXXXTXTXTXXXTXXXTXXXXXTXTXXXXXXXTXTXXXXXXXTX
XTTTTTTTTTXTTTXTTTTTTTXTXTTTTTTTTTTTTTXTTTTTTTTTTTXTTTTTTTTTX
XXXXXXXXXXXXXXX3XXXXXXXXXXXXXXXXXXXXXXXXXXXXXXXXXXXXXXXXXXXXX
