WTTTTTTTSOOOO
TXXTXIXTDHHHH
TXXTXIXTGOO1H
BZXTXXXTSOOOH
BXXTXXXTGOO2H
BBBRBBBBEHHHH
XXXXXXXXGOOOO