WTTTTTTT
TXCTXTXT
TZXTXTCT
BXXTX2XT
B2CTCXXT
BBBBBBBR