WTTTTTTTSOOOO
TX3TXTXTDHHHH
TXXTXTZTGOO1H
BZXTX1XTSOOOH
BXXTXTXTGOO2H
BBBBBBBREHHHH
XXXXXXXXGOOOO