W678776T
TZX7X8ZT
T2X6X8XT
BX17X2XT
BXZ6XX3T
BBBBBBRT