W678776T
TXX7X8XT
TXX6X8XT
BZX7X2XT
BXX6XXXT
BBBBBBBR