WTTTTTTTT
TXCTFIIXT
TXXTIIIXT
BZXTCX2XT
BXCTXXXXT
BBBBBBBBT