WTTTTTTTT
TXXXZX1XT
TXX1TXXXT
TTTTTTTTT
TTTTTTTTT
TXXIII1XT
TX2IZIXXT
TXXIIIX2T
TTTTTTTTT