WT1TTTZGTT
TTTTXTXGT2
FTXXTTTETT
TTTXTTGSTT
TXTTTTETTZ
TXXTZTG1TT
3XTTTTGST2
