W1TTTTTTTTTTTT
TZTTXTTTTTTTTT
TTTTTTTTTTTXTZ
TTTTTTTTTXTTXT
TTTTXXTTT2TTXX
Z3T3TXTTXT2TTT
XTTXXXTTTT2TT2
TXTT3TT3XXXTTT
TXTTTTTTT3T3Z1
TTTTXTXTTTT3TT
2TTTTTTTXTTX1T
ZTTTTTTTTTTTTT
T3XTTT3Z31TTXT
XXTTTTTTTXX3T3
