WTTTT3TTTTTTTTTTTTTTTTTT3TTTTXTTTTTTTT
3TXTTTTTXXTTTTTTTT2X3TTTTXTTXTT3TTTTTT
TTXTTTTTTTTTTTTTT3TT1XTTTTTTTTTTTTT1TT
T3TTTXTTXTTTTTTTTTT1TXTTTT3TTTTTTTTTTT
TTTTTTTTTTTTTTTTTXTTTTTZTTTTTTXTTTTTTT
TTXTTTTTTTTTXTTTTTXTT1TTTTTTZ1TTTTTTXT
TTXTTTTTTTTTTTTTTTTTXTTXTT2TTTTTTTTTTT
TTTTTTTTTTXTTTTTT2T1TTTTTTTTTTTXTTXTTT
TTTT1TTTTTTTTTTTT2TTTTTTTTTXTTTZTTTTTT
TTTTTTTT3TTTTTTTTZXTTTTZTTTTTTTTTTTTTT
TTTTXTTTTTZTTTTTTTTTTTTTTTTTTTTTTTTTTT
ZTTTTXTTT1TTTTTT2TTTTXTTTTTTTXT2TX3TTT
TTTXTTTTXXTTTXTTTTTTTT2ZTTTTTTTTTTT1TT
TTTTT1TTTTTTXTTTTTTTTTTTTTTTTXXTTTTTTT
TXTTTTTTTTTTTXTTTTTTTTTTT1TTTTTTTTTTTT
TTTTTTTTTTTTTTTTTTXTTTTTTTTTTTTXTTTTXT
TTTTZTTTTTTTTTTTTTTTZTXTTTTTTTZTT1TTTT
T1TTXXTTTTTT3TTTTTTTTTTTTXTTTTXTTTTTTT
TTTTTTTTTTTTTTTTTTTTTTTTTXTTTTTTTTT1TT
TTTTTTTTT2TTTTT3TTTTTTXTTTTXTTTT1TTTTT
TTTTXTTTTTTTTTXTT1XTTTTTTTTTT3TTTTTTTT
XTTTTTTTTTTTTTTTTT1TTXTTT3XTTTTTTTTTTT
TTXTTTTTTTT3TTTTTTTTTTTTTTTTTTTTTTTTTT
TTTTTTTTTTTTTTTTTTTTTTTTTTTXTTTTTTTTTT
TTTTZ2TTTTTTXTTTTTTTTTTTTTTTTTTTTTTTTT
TT1XTTT2TTTTTTTTTTTTT2XTTTTXTTTTTTTTTT
TTTTTTTTTTT2TTTTTTTTTTTTTTTTTTTTTTTTTT
TTT2T2TTTTTTTTTTTTTTTTTTTTTTTXXTTTTXXT
TTTTTTTT2TTTZTTTTTXTTTTTTTXTTT1TTTTTTT
TXTTTTTXTTT1TTTTTTTTTTTTTTZTTXTTTTTTTT
TTTTTTTTTTTTTTTTTTTTTTTTTTTXTTTT1TTTTT
TXTTTTTTTXTTTXTTTTTTTTTTTTTTTT3TTTTTT1
TTTT1TTTTTTTTTTTTTTT2TTTTT2TZTTXXTTT1T
T2TTTTTTTTTTTTTTTT3TTTTTTTTTT1TTTTTTTT
XTTTTTTTTTTTTTTTTT3TTTTTTTTTTTTTZTTTTT
TTTTTTTTTTTTTTTTTTT1TTXTTTTTTTTTTTTTTT
TTTXXXTTZTTTXTTTTTX2XTTTTTTTTTTTTTTZ3T
TTTTTTTTTTXT1TTXTXTXTTTTTT2TTTTTTTTTTT
