WXTTTTTTTTTTTTTTTTTTTTTTZTTTTTTTTT
TTXTT11ZTTTTZT3TTTTTTTTTTXTT3TTT3T
TTXT2TTTTTTTTTT1TTT2TTTTTTTTTX2TTT
T3TTT1TTTTTTTTTTT3TXTTTXT3TTTTTTTT
TTTTTTTTTXTXTXTTTTTTTTTTTTTTTTTTTT
TXTTTTTTTTXTTTTTTTTTXTTTTTTTTTTTTT
XTTTTTTTTTTTTTTTTTTTTTTTTTTTTTT3ZT
TTT2TTTTTT1TZTX2TTTTTTTTTTTTTTTTTT
TTTXTTTTTTTTTTTT1TTTTTTTTXT3TTTTTT
TTXTTTTTTTTTTTTXTTTTTTTTTT3TTTTTTT
TTTTTTTTTTTXTT2TTT1TTTTXTTT3X1T1TT
TTTTTTTTTTTTX3TXTTTTTXTTTTTTTTTXTT
TTTTTTTTTT3T2TXTTTT3TTTTTTTTTTTTTT
TTTTXTTTTTTTTTTTXTTTTTTXTTTTTTTTTT
TTTTTTTTTXTTTXTTTTTTTXTTTTXTTTTXTT
TTXTT3TTT1T3TTTTTTTTTXTTTT2TTTTTTT
TTTXT2TTTTTTTXTTT3TTTTZTTTX11XTTTT
TTTTTTTTTTTXTTT1ZTTTTXTTTTTTTTTT2T
TXTXTTTTTTTTTTT1ZX1TTTTTTTTTTTTTTT
T3TTTTTTTTTTTTTTTTTXTXTTTTTTTZTXXT
TTTTTTXTTTTTTTZTTTTTTT2TTTTTTTTTTT
TTTTTTTTTXTTTTTTTTXTTTTTT2TTTTTTXT
TTTXTXTT2TTTTXTTTXTT1TTTTTTTTZTTTT
T1TTTTTTTTTTTTTTTTTTTTTTTTTTTTTTTT
TTT3TTTTTTTTTTTTXTTTTTTTTXTTXTTTTT
TTTTTTTTTTTTTTTTTTT3TTTTT1TTTTTTTT
TTTTTTTTTTTXTTTTTTTTTTTTTTTTTTTTXT
TTTXTTTXTTTTTTTTTTTTTTTTTTTTTTTTTT
TTTTTTXTTTTTXTTTTTTTTTTXTTTTTTTTTT
TTTTTXTTTTTTTTTTTTT3TTTTTTTTT2TXTT
TTTTTXTTT1TTTTTXTXTTTXTTTTTTTTTTTT
TTTTT1TTTTTTTTTTTTTTTTTTTTZTTTTTTT
TTTTTTTTTTTTTTTTT2TTXT3TTTTTTTTTTT
TTTTTTTXTTTTTTTTTTTXTTTTTTTTTTTTTT
