WTTTTTXTTZ2T1TTTTTT22
TTTX2XTXTTXTTTTZTTT13
TTTTTTTTTTTTTTTXT3TTT
TT3TTTT1TTX2TTTTTTTTX
XTTTTTTTTTTT3XTTTTZTT
TXXTTTTTTTTTTXTTTTTTT
TTT2TTTTXTTTTTTTTTTTT
TTTTTTTXTTTTTZ13X23XX
TTXTT3XTTTTTTTXTTT1TT
T12TT13TTTTTT3TTX1TXT
T1TXTTTXTTTXTTTTTTTTT
TT2TTTTTTTTXTTTTTTTZT
TTTTXXTTTTTTTTTTTTTTZ
TTTTTTTTZT3TTTTTTTTTT
TXTTTTTTT1TZTTTTTZXTT
TTXTTXTTTTTTTTTTTTTTT
TTTTXTT2T1TTTTTTTTTTT
TTTTTTTTTXT1TTTTTTXTT
2TTTTXTXTTTTTTTTTTTXX
TTTZTTTXTTXTTTTTTXTTT
22TXTTTXXTTTTTTTTTTTT
