WTTTT2TTTTTTTTXTTTT
TTXTTTTT23TTZTZXXTT
TTXTTTTZXTXTTTTTXTT
1TTTTTTXTTTTTTTTTTT
TTXTTT3TTTTTTT3TXTT
TTTTTT1XTTXTTT1TXTX
T1TT2XT3TTTTTTTTTTT
TTT2TTXTTXTXTXTTTTT
TTT2TTXTXTTTTTT1TXT
TTTTTTTTTTXTTTTTTTT
TTT2TTZTTT2TTTTXTTT
TTTXTXTT33TTTTTTTTT
TXTTTT22TTTTTTTTTTT
TTTTTTTTTTTT2X3XTTT
TTTTTXTTTXT32T2XTTT
TTTTTTXTTTT1TTXTTTT
T2TTTZTXTTTXTTTXTTX
ZTXTTTTTTTTTTTTTTTX
TT2TZTTT1XTT31TTTTT
