WTTTX1TTT
TT2TTXXXT
3XTTXTTTT
TXXTXTXTZ
TTTT2T1TT
T3TXTXTTT
TT2TTTTXT
T2T1XTTXZ
T2XTTTTTT
