W3TTTTTTTTTTT2TTTTTTTTTTTTTTTTTTTTTT
TTTTTTTXTXTTTTTTTTTTTTTXTTTXTTTTTTTT
TTTTXTTTTTTTTTTTTTTT33TTTT1TZTTTTTTT
TTTTTX1TTTTTTTTTTTTTTXTTTTTTTTTTT2TT
T1TTTTTTTTTTTTTTXTTTTTTTTTT2TZTXZTTT
TTTTTXTTTTXTTTTTTTTTTTTTTTT1TTTTTTTX
TTTTTTTTTTTTTT1TTTT3TTTTTTTTTTTTTTTT
TTXTTTTTTTTTTTTTT2TTTZXTTXTTTTTTTTXT
2TZTTTTTTTTTTTTZTTTTTZTTTTTTTTTTTTTX
XTTTTXTXTTT3TTTTTTTTTTTZ2XTTTTTTTT1T
TTT3TTZTTXTTTTTTTTTTTTTTTTTTTTTTTTTT
XTTT3TXTT1TTTTTTXTT3XTTTTTTTTXTTTTTT
XTTTTTTTTTTTTTTTTTTTTT1TTTTTTTTTTXTT
TTTTTTTTTTTTTTTT3TZTTTTTTTTTTTXTTTXT
TTTTTTTT3TTTTTTTTTXT3T2TTTTTTTTTXTTT
TTTTTTTTTTTXT3TTT3TTTTTTTTTTTTTTTTTT
TTTTTT1TTTTTTTTTTTTTT1TZTTTTTTTXTTTT
TTTTTTTTTTTTTTTXTTX3TTTTTTTTTTTTTTTT
X2TTTTTTTXTTTTTT3TTTTTTTTTTTTTTTTTTT
TTTTTTTTTTTTTTTTTTTTTTTT1TTTTTTTTTTT
TTTTTT2TTTTT2TTTTTTTTTTTTTXT32TTTTTX
TTTTTTTTTT3TTTTTTTTTT2TTTTXTTTTTTXTT
XTTT2TTTTTX3TTTTXTTTTTTXTTTTTTTXT1TT
T1TTTTTTTXTTTTTTTTTTTT1XTTTTT1TTTTTT
1TXTTTTT1XTXTXTTTTTTTTTTTTTT2TTTTTTT
XTTTZTTTTT1TTTTTTXTTTX1T1TTTXTTTTTTT
TTXTTTTTTTTTTTTZTTTTTTX2TTTTTTTTT3TT
TTTTZTXTTXTTTTTTTZTTTXXXTTTTTTTTTTTT
TTTTXXTTTTTTTTTTXTTTTTTTTTTXTXTTTTTX
TTXX1TTTTT2TTTTT1TTTTTTTTTTTTTTTTT1T
TTTTTTTTTTTTTTTTTXTTTTTTTTT3TTTTTTTT
TTTTTTTTTTTTTTTTTTTTTXTTTZTTTTTT2TTT
TTTTTTTTTTTTTTXTTTTTTTTTTTTTTTTTTXTT
TTTT1TTTTTTXTT1TX3TTTTTTTTTTTTTTTXTT
TTT2TTTTTTTTTTTTTTTTTTT2TXTTTTTTTTTT
TTTTTTTTT2TTTTTTTTTTTTTTTTTTTTTTXXTT
