WTTXTTTTTTTTTTTTTTTTTTTT3TT
TTT1TTT1TTTTTXTTTZT1TTTTTTT
TTTTXTTT3TTTTTXTTTTT3XTTT1T
1TTTTTTTTTT31TTTTTTTTTTTTTT
TTTXTZTTTTTTTTTTTTT1TTTTXTT
TTTTTTTXTTTTTTTT1TTTTTTTT3T
TTTTXTTTTTTTTTTTTTTTTT3TTTT
TTTTTTTTTTTTTTTTTT3TXTTTTTT
TTTTXTTTTTTTTTTTTTTTTTTTTTT
TTTZT2TTTTXTTTTTZTTTTTTTXXT
XTTTTTXTTZ1TTTTTXTTTTTZTXTT
TTTXTTTXTT3XTTTTTTTTT1TTTTX
TTTT32TTTT32TTTXTTTTT2TTTTT
TTTTTTT2TTTTTTTTTTTTTXT1TTT
TTTTTTTTTTTTTTTTXTTTTTX2TTT
TTTTTTTTT3XTZTTXTTTXX1TTTTT
TTTTT1XTTTTTTXTTTXT3TTTTTTT
3TTXTTXXXT1TXTTTTTTTXTTTXTX
TTXTTTTTTTTXTZTTXTTTTTTT2XT
TXTTTTTTTTTXTTTTTTTTTTTTTTT
TTTTT2TXTTT2TTTTTTTZTTTTTTT
XTT1TTTXTT2ZXT2TTTTXTTTTTTT
TTTTTTTXTTTTTTTZTTTTTTTXTTT
TTTTXTTTTT1T1TTTTTT1XTTTTTT
TTTTTTXTTTTTTXTZ21TTTTTTTTX
TTTTTTT3TTTTT3TTTTXTTTTTTTT
TTXTTTTT3TTTTTTTTTT2TXTTTTT
