WTTZTTTTTTTTTTXTTTTXT2TTTXTTTT
TTTTTTTTTTTTTTTTTTTTTTTT1T1TTT
TTTXXTTTTXTTTXT1TTTTTTTTTTTTXT
TTTTTTTTTTTTTTT3TTTTTTTTTTTTTT
TTTTTT2TTTTTTTTTTTTTTTT1TTTTTT
TTTTXTTTTTT1TTTTTXTTTTT1TTTTTT
TTTTT2TTTTTTTZTTTTTTTT2TT2TTZT
TTT11TTTTTTTT2TZT3TXTTTTXTXTTT
TTTTTTXTTTTTTTTTTTTTXTT3TTTTTT
TTTTTTTTTTTTTTTTTTT2TTTT2TTTTX
TTXTTTTTTTTTTTTXTTTTTTTTTT2TTX
TTTT2TTTTTTXXXTTTTTTXXTTTTTTT1
TTTTT1TTZTTTTTTT32TTTXTTT2TTXT
TXTTTTTTTTTTTZTTXTTTTTTZTTTTTT
TTTTT1TT2TTTXTZTTTTXTTTTTTTTXX
TT2TTTTTTTTTTTTTTTTTTTTTTTTTTT
TTTTXTTTTTTTTTTTTTTTTTTTTTTTXT
TTZTTTTTTTTTTTTT2TTTTTTTTTXTTT
TXTXTTTTTTTXTTTTTTXTTTTTXXTTTT
TTTT2TTTTTTXTXTTXTTTTTTTTTT3TT
TTTTTTTTTTTTZTTTTTTT2TTTTTTTTT
TTTTTTTTTTTXTTTTTTTTTTXTTT3TTT
TTTTXTXTXTTTTTTTTTTTTTT3TTTTTT
TTTXTTTTX1TZTTTTTT3TTTTTTTTTXT
TTTT1TTTTTTTTTTTTT3TTTTTTTTTTT
TTTTTTTTTTTT1TTTTT3ZTTTTTTTTTT
32XTTTTTT2TTXTTT1TTTTTT1TTTTXT
TTTTX1TTT2TTTTXTTXTTTTTTTTTTTT
TTTTTTTTTTXTTXTTT3TTTTTTTTTTTX
TTTXTXT1TTTTTTTXTT2TXTXXTTT1TT
