W2TT3T3TXTTTTTTTTXTTXTTTZTTTTT3TTTX2T
TTTTTTTTT1TTTTTTTTTTXTTTTTTTTTTTTTXTX
XTTTTTTTXT3TTTTT1TTTTTTTTTTTTTTXTTXTT
TXTTTTTTTTTT3TTTXTTTTTTTTTTTTTX1XTTTT
XTTTTTT2TTX1TTTTTTT1TTXTTTTXTT3TTT2XT
TT2TTTTTTTTXTTTTTTTTTTTTXTTTTTTTTTTTT
TXXTTTXTTTTTTTTTTTTTTTTT1TTTTTTTTTTTT
TTT3TTTTTTTTTTTTXTTTTTTTTTT3TTTX2XT2T
TTTTTZT3TTTTTTTTTTTTTTTTTTT3TTTTTTTTX
TTTTTT3TTTTTTTTXTTTTTTTTT2TT1TTTTTTTT
3T2TTTTTTT2TTTTTTTTTTTTTTTTTTTTTTTTTT
TTTTTTTTTTTTTTTT3T3TTTTTTTTTTTTTTTTTT
TTTXTTTTTTTTTTTTTTTTTTTTTTTT3TTTTTTTT
TTTTTTTTTTTTTTTXTTTTTTTTTTTTTTTTTTTTT
TTTTTTTTTTTT3X3TTTTTTTTXTTTTTTTTTTTT3
TTTTTTTTTTTTTTTTXTTTTTTTTTTTTZT3TTTXT
TTTTTTTTTTTTTTXTTTXTZTTTTTTTTTTTTTTTT
TTTTTXTTTT3TTTTTTTTTTTTTTTTTTT3XTTTTX
T1TTTTTTTTTTXT2TTTTTTTTXXTTT2TTTTTTT3
TTTTTT1TT2TTTTXTTTTTTTTTTXTTTTTTXTTXT
TTXXTTTTTTTTTTTTTTTT1TTTTTTTTTTTTTTTT
TTTTTTTTTTTTTZTTTT1T2TXTTTT1T3TTTTT2T
TTTTTTTTTTTTTTZTTTTTTTTXTTTXTTTTT2TT2
TTTXTTTTTZTTXTTTTTTTTTTTTTTTTTTTTTTTT
TXXTTTTTTTTTXTTTTTTTTTTXTTTTTTTTTTTTT
TTTXTT1TTTTTTTTTZT2TTTTTTTTTTTTTTTTTT
TTXTTTTTTZTTTTTTXTTTTTTTTTTTTTTXZTTTX
XTTT1TTTTTTTTTTTTTTTTTTTTTTTTTTTZTTTT
TTTTTTTTTTTTTTTTTTTTTTTT1TT2TTTTTTTTT
TTTTTTTTTTTTTTTTTTTTZTTTTTTTTTXTTTTTT
TTTTTTTTTTTTTXTXTTTTXTTTTTTXXTTTTTTTT
TTTTTTTTTXTTTTTTTTZTTTTTTTTT3TTTTTTTX
TTTTXXTTTTTTT3XTTTTXTXTTTTTTTTTT3TTTT
TXXTTTTTTTTTTTTT3TTTTTTTTTTTT1TTTTTTT
T3TTTTTTTTTTTTTXTTTTZTTTTTZTTTTTTTTXT
TTTTTTTXTTTXTTTTTTTTTTTTTTTTXTTTT2TTT
T2TTTTTTXTTTTTTTXTTTTTTTTTTTTTTTTTTTT
