WTTTTTTTTTTTTTTTTTTTTTTTTTT3TTTTTTTTTTTTT3TT
TTTTTTTTTTXTXTTTTTXTTTTTTTTTTTT2TTTTTTTTTTTT
TTTTTTTTTTT2TTTTTTTTTTTTTTTTTTTTTTTTTTTTTTT3
XXTXTTTTTTXTTTTTTTTTTT2TTTTTTTTTTTTTTTT1TTTT
TTT12TTTTTTTTTTTTT2TTTTXTTTTTTTTTTTTTTTTTTTT
TTTTTTTTTTTTXTTTXT1TTTTTTTTXTTTTTTTTXTTTTZTT
TTTTXTTTTTTTTTTTTTTT2TTT1TTTTTTTTXTTTTTTZTTT
T1TTTTTTT2TXTTTTTTTTTTTTTTTTTTTTTTTT1TTTTZTT
TTTT1TTTTT1TTTTTTTTTTTTTT32TTXTTXTTTTTTTTTTT
T1T13TTTTTTTTTT1TTTTTTTTT3TTTTZTTTTTTTTTTTTT
TTTXTTT2TTTTTTTTTT1TTTTTT2TTTTTTTTXTTTTTTTTT
TXTTXTTTT2TTTTTT1TTTTTTTTZTXTTTTT1TTTTTTTT3T
TTTTTTTXTTTXTTTTTTTTTTTTTTTTTTTTTTTTTTTTTTTT
TTTTTTTTTTTTTTTTTTTTXTTTTTTTXTTTTTTTTTTTXTTT
TTTTTTTTTTTTTTTTTTTTTTTTTTTTTTTTTXT1TTTTTTTT
TTT1TXTTTTTTTTTZTTTT2TTTTTTTTTTTXTTTTTTXTTTT
XTTXTTTTTTTTTTZTTT2TXTTZTT3TTTTTTTTTTTT3TTTT
TTTT2TTTTTTTTTTTTXTTTTTTTTTTTXTTTTTTTTXXTTXT
TTTTXTTTTTTTTTXTTTTTTTTTZTTTTTT3TTTTTTTTTTTT
TXTTTTTTTTTTTTTTTTTTTTTT1TTTTTTTTTTZXTTTXTTT
TTTTTTTTTTTTTTTTTTTTTXTTTTTTTXTTTTTTTTTXTTTT
TTTTZTTTTTTTTTXTTTTTTXTTTTT33XTTTTTTTTTTTTTX
TTTTTTTTTTTTTTTTTTTTTTXTTT3TTTTXZTXTTTTTTTTT
XTTTXTTTTTTTTTTTTTTTTTTTTTTTTTTTTTTTTTTTTXTT
TTTTTXTTTTXTTTTTTTTTTZTTTXTTTTTTTTTTT2T2TTTT
TTTTTTXTTTTTTTTTTTTTTTTT2TTTXTTTTTTTTTTTTTTT
TTTTTTTTTTTXTTTTTTTTTTT2TTTTTXTTTTXTTT3TTT1X
TTTTTTTZTTTTTTTTTTT2TTTT2TTTTTTTXTTTXTT1TT2T
TTTTTT2TTTTTTTTTTTTTTTTTTTTTTTTTTTTTTTTTTTTT
TTTTTTTXTTTTTTTTTTTTTXTTTTTTXXTTTXTTTTTTTTTT
TTTTT3TTTTTTTTXTTTTTTTTTZTT3TT2TTXTTTXTTTTTT
TTTTTTTTTTTTTTTTTTTTTTXTTTTTTT2TTTTXTTTXTTTT
TTTTTXTTTTTTTTTTTTTTTTTTTTTXTTTTTTT1TTTTTTTT
TXTTTTXTTT3TTTTTTTTTTXTTTTTTTT3TTTZTTT1T2TTT
XTTTTTTXXTTTTTTTTTTTTXTTTTTTTTTTTT2TTTTTTTTT
TTTTTTTT1TTTTTTTTTTTTTTTTTTTTTTTTTTTTTTTTTTT
T2TTTTTTTTTTTTTTTTTTTTTTTTTTTTTTTTTTTTTTTTTT
TTTTTTTTTTTTTTTTTTTTT1TTTTTTTTTTTTTTTTTTTTTT
TTTTTTZTTTTTTTZTXT3TTTTTTTTTTTTTTTTTTTTTTTTT
TT1TTXTZTTTTXTTTTTTZTTTXTTTTTTTTTTTTTTTTT1TT
TTTTTTTTTTTTTTTTTTXTTTTTTTT2TTTTTTTTXTTTTTTX
TTTX3TTTTTTT2TTTTTTTTTTTXTTTTTTTTTTTTZTTTTTT
TZTTTTXTTTTTTTXTTTTTTTTTTTTTTT2TTTTTTXTX2TTT
TXTTTXTTTTTTTTTTTTTTTTT2TTTTTTTT1TTTTTXTTTTT
