WTTXTTTTT2TTXTTTTXTTTTT1T
2XZT3TTTT2TT2TTTTTTT2TTTT
3TTTTT2TTT2XT31TTTTTTTTTT
T2XTTTTTTTXTTTXTTTTTTTTT2
TT1TTTTTXTTTTTTTTTTTTTTZT
TTTTTTTTTTTTT3TTTTTTTTTTT
TTTXTTTTXTXTTXTTTTTTTTTTT
XTTTTTTTTTTTZTTTXTT3TXTTT
XTTTTTTTTTTTTTTTTTTTTTTTT
TTTTXTTX2XTTTXT2TTTTXTTTT
XTT3TTTTTTTTZTTTTTTXTTTTT
XTT2TTTXTTXTTTTTTXTTTTTTT
TTTXTTTTTTXTTTTTTTT22TTTT
TTTTZTTTTTTTTTT2TTTXTTTTT
TTTTTTTTXTTTTTTTTXXTTTT2X
T3TTTTTTT3TT3TTTTTTTTTTTT
TTXTTTTTTT2TTTTTXTTTT3XTT
TTTTTTTTTTTTTXT2TXTTTTTTT
XTTTTTTTTTTTTTT2TTTTTTTTT
TTXTTTXTTTZTTTTT1TT132TTT
TTTTTT1XTTTTTTTTXTTTTTTTT
TTTTZTXTTTTTXTTTXTTTZTTTT
TTTXT1TTTTTTTTX32TTXTXXTT
TTT1TTTTTXTTTTTXTTTTTTTTT
TXTTTT2TTTTTTTT1TTTTTTTTT
