WTTTT2X1TTTT
TXTTXTTTTTXT
TTTT1XTXTTTT
TTTT1TTTTT31
T3ZTT1TZZTTT
XTTTTTXTT1TT
TTTTX1ZTXTTZ
3T3XTTTTTTXT
TTTXXTTXXTTX
TX2TTXT3XXTT
1TT2TTTTTX23
TTTXXZ2TTTTT
