WTTTTTTXTTTTTXTTTTTT
XXZTTZTTXTTTTTTTTTTT
TTXTTTTT2TTTTTTTTXZT
TTXTTTXXTTTTTT1TTTTT
TTTTTTTTT2XTTTTXXTTT
TTTTTTTTTTXTTT3TT1T3
XTZTTTTXTXTTTTTTTTTT
TTXTXTX12TTTTTTTTTTX
TTTTTT3TT2TTTTTT1TTT
TTZ1TT3TTTTT1TTTTTXT
TTTTTTZTTTTT3TXTTTTT
TTT3TTTTXTTTTTTTTTTT
TTTX2T2TT2TTTXTTTTTX
TTTTTTXTTTXTTTTXXTTT
TTTTTTTTZTXTTTTTTT3T
TTTZTTTTTTXTXT2X2TTT
TTTTXTTTTTTX3T1XT3TT
T2TTTXTTTTTTTTTXTT1T
TTTT2TTZT22XTTTTT3XT
TTTTTXTTTTTTTTTXTXTT
