WTTTTTTTTTTTTTTTTTTTTTTTTTTTTTTTTTTTTTTTTT
TTTTTTTTTTXTTTTTTTTTTT2XTTXTTTTTTTTTTXTTTT
TTTTTTTTTTTTTTTTTTXTTTTTXTTTTTXTTTTTTTTTTT
TTTTTTTTTXTTTTTTTTTTTTTTTTTXTXTTTTTTTTTTTT
TXTTTTTTTT1TTTTTTTTTTTTTTT3TTTTTTTTTTTTTTX
TTTTTTTTTTTTTTTTTTT3TTTTTXTTTTTTTTTTTTTTTT
TTTTT3TTTTTTXTTTTXTTXTTTTTTTTTTTTT2TTTTTTT
T12TZTTTTTTTTXXTTTTTTXTTTTZTTTTTTTTTTTTTTT
TTTTTTTTXTTTTTT3TTTTTTTTTTTTTTTXXT2TTTXTXT
TTTTXTTTTTTTTT2TZTTTTTTTTTTTTXTTTTTTXXTTTT
TZTTTTTTTTTTTTTTTTTTTTTTTTTTTTT2TTTTT3TTTX
TTTTTTXTTTTTTXXTTTTTZTTTTTTTTTXTT23TTTTTTT
TTTTTTTTXTTTTT2TTTTZTTTTTTTTTTTXTTTTTTT2TX
TTTTTTTTTTXTTXTTTTTTTTTTTTTTXTXTTTXT3TTTXT
TTTTTTTTXTTTTTTTTTTTTTXTTTTTTTTTTTTTTTTTTT
TTTTTTTTTTTTTTTTTTTTTTTTXTTTTTTTTTTXTTTTTT
TTTTTTTTTTTTT2TTTT2TTTTTTTTTTTXTTTT3TTTTTT
TTTTTTTTXTTTTTTTTTTTTTTTTTTZ2TTTXTTTTTTTTX
T3XTTTTZTTTT1TXTTTTTTTTTTTTTTTTT2TTTTZTTTT
TTT3XTTTTXTZTTTTTTTTTT1TTTTTT3TTZTTTTTT3TT
TTXTTTTTTTTTTTTTTT2TTTTTTTTTTTTTTTTTTTTTTT
T1TTTTTTTTTZTTTTTTTTTXTTTTTTTTTTTTTXTTTTTT
TTTXTTTTTTTTTTTTTTTZTTTTTTTTTTTTTXXTTT3TTT
TTTT2TTTTTXTTTTTTXTTTTTTTTTT1TTT31XTXTTTTT
TTT2TTTTTTTTTTTTTTTTTXTTTTTTT2TTTTTTT2TTTT
1TTTTTTTTTTT2TTTXTZTTTTTTTTTTTTTT3TTTTTTX1
3TTTTTXTTTZTTXTT2TTTXTTTTT2TTTT2TTTTTTTTTT
TTTTTTTTTTTTTTTTTTZT1TTTTTT3TTTTTTT1TTTTTT
TTTTT2TTTT3TT2TTTTTT13TTTXTTTTTTTTTTTTTTTT
TTTTTTTTTTXTTXTTTTTXTTTTTTTTTTTTTT2TTTTTTT
TTTTTTXTTTTZTTTTTTTTTTTTTTTTTXXTTTTT2T1TTT
TTTTTT3XTTTXTTTTTTTTTTTTTTTTTTTTTTTTTXTTTT
TTTTTTTTTTTTTTTTTTTTTTTTTTTTTTTTTTTTTTTTT2
TTTTTTTTTTTXTTTTTTTTTTXTXTTTXTTT1TTTTTTTTT
TTTTTTZTTTT3TT3TTTTTTTTTTTTTTTTTTXTTTTTTTT
TTTTTXTTTTTZTTXTTTT2TT1TTTTTTTTXTTTTTTTTTT
TTTTTTTTTTTTTTTTTTTTTTTTTTTTTTTTXTTTTT2TTT
XTTTTTTTTTTTTTTTT1TTTTTTTTTTTTTX1TTTTTTTTT
TTTTTXTTTTTTTTTTTTTTTTTTTTTTXTTTTTTTTTTTTT
TTTTTTTTTTTTTTTTTTTTTTT3TTTTZTTTTTTTTTTTTT
TTZXTTTTT3T1TTTTTXTTTTTTXTTTTTTTTTTTTTTTTT
TTTTTTTTTTTTTTTTTTTTTTTT2TTTXTTTTTTTTTTTTT
