WTTTTTTTTTTT3TTT1TTTT1TTTTTT1TTTTTTTTTXTTTT
TTTTTTTTTTTTT1TTTXTTTTTTTTTTTTTTTTTT1TXTTTX
TTZTTTXTTTTTTTTTTTTTTXTTTTTXTTTXTT2TTTTTTTT
TTTTTTTTTTTTTTTTTTTT3TTTTTTTTTTTTTTTTTTTTTT
TTTTTTTTTTTTTTTX1TTTZTTTTTTTTTXXTT1TTTTTTTT
TTTT1TTTT33TZTTTTTTTTTTXTTTTTTTTTTTTTTTXTTT
TTTTTTTTTTTTTTTZTTTTT2TTXTTT2TTTTXTTTTTTTTT
XTTTTTTTT2TTTXTTTTTTTTXTTTXTXTTTTTTTTTXTTTT
TTTTTTTXTTTTTTTTTTTTTT1TTTTTTTTTTTTTT3TTTTT
TTTTTTTTTTTT2TTTTTTTTTTTTTTTXXTTTTXTTTTX1TT
TTTTTT2TXTTTXTTTTTXTTTTTTTTTTTTT1TTTTTTXTTT
TTTT3TTT2TTT2TTTXTTTTTT2TTTT3TTTTTTXTTTTTTT
TTTTTT1TXTXTTTTTTTT1TTTTTTT2TT2T1TT3TTXTTTX
TTTTTTTTTTTTTTTXTTTTTTTTTTTTTTTTTTT3TTTTTXT
TTTTTTTTTTTTTTT2T3TTTTTTTTTTTTT3TTTTTTTXTTT
TTTTTTTXTTTTTTTT1TTTTTTTTTTTTTTTTZTTTTZTTTT
TTTTTTTTTZTTTTTTTTTTTTTTTTTTTTTTTTX1TXTTTTT
TTTTTXTTTTTTTTTTTTTTTTTTTTTTTTZTTTTTTTTTTTT
TTTTTTTXTTTTTTTTTTXTTZTTTTTTTTTTTTTTTTTTTTT
XT1TTTTTTTTTTTTTXTTTTTTTTTXTTTTXTTTTXTTTZTT
TTTTTT2TTXTTTTTTTTT2TTXTTTTTTTTTTTTTTXTTTTX
TTTTTTTZTTTTTTTTTTXTX3ZTTTTTTTTTTTTTTTTTTTT
TTTTT1TXTTTTTTTTTTXTTTTTTTTTTTTTTXTTTTTTTTT
1TTTTTTXTTZXXTTTTTTTTTTTTTTTTTTTTTTTTTTTXTT
TTTTTT1T2TTTTTTTTTTTT1TXTTT2TTTXTTTTTTTTTTT
TTTXTTTTTTTTTTT1TTTTXTTTTTTTTTTTTTTXTTTTTTT
TTTTTT1TTTTTTTTTTTTTTTTTTTTTTTTTTTTTTTTTTTT
TTTTTTTTTT1TTTTTTTTTTTTTZTTTZTTTTTTTTTTTTTT
TT3TTTTTTTTTT3TTTTTTTXTTTXTXTXTT1TTT2TTTTTT
TTTTTTTTTTTXTTTTTTTTTTTT3T3TTTTTTTTTTTTTTTT
XTTTTTZTTTTTTTTTTTTTTTTTTTTTTTTTXXTTTTTTTTT
TTTTTXTTTTTTTTTTTTTTTTTTTTTTTTTTTTTTTTTTTTT
TTTTTTTTTTTTXTTTXTTTTTTT2TTTTTTTTTTTTTT2TTT
TTTT3TTTTTTTTTTTTTTTTTTTXTTTTTTTTT2TTTT1TTT
TTTTTTTTT2T3TTTTTTXT2TTTTTTTTTTTTTTTTTTTTTT
TTTTTTTTTTTTTTTTTTTTTTTTTTTTTXTTTTTTTT1TTTT
TTTTTTTTTTTTTTTTTTTTTTTTTTTTTTTTTTTTTTT2TZX
TXTTTXTTXTZTZTTTTTXTTTTTTTTTTTTTTTXTTTTTTTT
XTTTTTTTTXTT2TTTTTTTTTTT1TTTZXTT1TTTTTTTTTT
TTTTTTTTTTTTTTTTTTTTTTTTT2TTTTTTTTTTTTXTTTT
XXTTTTTTTTTTTTTTTTTTTTTTTTTTTTTTTTTTTTTTTTT
TTXTTTTT3TTTTTTTTT2XT1TTTTTTTTTTTTTTTTTTTTT
TTTTTTTTTTTTTTTTTT1TTTTTTTTTTT3TTTX1TT2TXTT
