WTTTTTTTTTXTTTZTTTTTTTTTTTTTTTTTTTTTXTTTTTTTT
TTTTTTTX3TXTTTXTTTTTTTTTTTTTTTTTTTTTTTTTTTTTT
TT1TTXTTTTTTTTTTTXTTTTTTTTTTTTTTTTTTTTT3TTTTT
TTTTTTTTTTTTTTTTTTTTTTXZTTTTTZTTXTTZTTXTXTTTT
TXTTTTTTTTTTTTTTTTTXTTTTTTTTTTTTTTTTTT2TTTTTT
TTTTTTXTTTTTTTTT3TTTTTXTT3TTTTTTTTTTTTT1TTTTT
TTTTTTTTTTTZTTTTXTT3T2TTTTTTTTT2TTXTTTTTTTTTT
TTTTTTT1TTTTTTTTTTTTTTT2TTTTTTXTTTZTTTTTTTTTT
TTTXTTTTTTTTT1TTTTTTTTTTT2XTTTTTTTTT2TTT3TTTT
TTT21TXTT1TTTXTTTTTTTTTTTTTTTTTTTTTTTTT2ZTTTT
TTXTTTXXTTT1TXTXTTTTTTTT2TTTTTTTTXTZTTTTTXTTT
TTTTTTTTTTTTTTTT3TTT2TTT11TTTTTTTTTTTTTTTTTXT
XTTTTTTTTTTTTXTTTTTTTTTTTTTT3TT1TTTTTTTTTTTTT
TTXTTTTTTTTTTTTXTTTTXTTTTTTTTTTTTTTTTTTTTTXTT
TXXXTTTTTTTTTTTTTTTTTTTTTTTTTTTTT1TTTTTTXXTTX
TTTTTTTTTTTTTXTTTTT1T2TTTTTXTTTTTTTTTTTTTT2TT
TTTTTTTTTTTTTTTTTTTTTTTTTTTTTTTTXTTTXTTTTTTTT
TTTZTTTTXTTTTTTTTTTTTTTXTTTTTTTT3TTTTTTTTTTTT
TTTT1TTTTTTTTTTTTTTTTT3TTTTTTTTTTTTXTTTTTT1TX
TTTTTTTTTTTTTTTTTT1TTTTTTTTZTTTTTTT1TTTTTTTTT
TTTTTTTTTTXTTTXTTTTTTTTTTTTTTTT1T3TTXTTTT1TXT
TTTZTTTXTTTTTTTTTTTTTTTTTTTTTTTTTTTT1TTTXTTTT
TTTTTTTTTTTTTTTTTTTTXTTTTTTTT3TTTTTTXTTTTTTTT
TTTTTTTTTTTXTTTTTTTTXTTTTTT22TTTTTXTZTTTTXTTX
TTTTTTTTTTTTXTTTTTTTTTTTTTTTTTTTTTTTTTTTTTTTT
TTTTZTTTTTTTTTTTTTTT1ZTTTTTT1TTTTTTTTTTTXTTT3
TTTTTT2TTTTTTTTTTTTTTT2TTTTTTTTTTTTTTTTTTTXTT
TTTTTTXTTTTTTTTTTTTTTTTTTTTTTTTTTTTTTTTTTTTTT
TXTTTTTTTTTXTTTTTTXTTXTTZTTTTTTXTTTTT1TTTTTTT
TTTTTTTTXTTTTTTTXTTTTTTTTX1XT2XTT3TTTTTTTTTTT
2TT1TTTTTTTTTTTTTTXTTTTTTTTT2XTTTTTTTTTTTTTXT
TTTTTTTTTTTTTTTTTTTTTT3TTTTTTTTTTTTTTTTTTTTTT
TTTTTTTTXTTXTTTXTTTTTTXT3TTTTTTTTXTTTTTTTTTTT
XTTTTTTTTTTTTTTTTTTTTTTTTTXTTTTTTTTTTTTTTTTTT
TTTTTTTTTTTTT2TTT3TTTTTTTTTTTTTTTTTTTTTTTTTTT
TTTT2TTTTTTTTTTTTTTTTTTTTTXZ1TTTTTTXTTTT2TTTT
TTTT3TTTTTTXTTTTTTTTXTTTTTTTTTTTTTTTTTTT3TT1T
TTTTTTTTTTTTTTTXTTTTTTTXTTTTTTXTTTTTXTTTTTTTT
TTTTTTXTTTTTTTTTTTTTTTTTTTTTTTTTT3TTTTTTTTZTT
TTTTTTX1TTTTTTT1TTTTTTTTTTT2TTTTTTTTTTTTTTTXT
TTTTTTTTTTTTTTTTTT32TTTTTTTTTTT1TTTTTTTTTTTTT
XTTTTTTTZXTTTTTTTTTTT3TTTTTTTTTTTTTTTTTTTTTTT
TTTTTTTTTTTTTXTTTTTTTTTTTTTTTTTTTTTTTTTTT2TTT
XTT3TTTTTZTTTTTTTTT2TTTXTTTTTTTT2TXTTTTTTZTTT
TTTTTTTTTTTTTTTTTTTTTTTTTTTTTTTTTTTTXTTTZTTTT
