W2XTTTTTTT1TTTTTTTTTTTTTTTTTTTT
TTT2TTXTXTTTTTTTTTXTXTTTTTTTTTT
TXT1TT3TTTTTTTTTTTTTTT2TTTTTXTT
TTTT2TTTTTTTTTX1TTTTTTTTTTTTTTT
TXXTTTTTTTTTTTTTXTTTTTTTTTTTTTT
TTTTTTTTTTTTXXTTTTTTTTZTTTTTTTT
TTTTTTTTTTTTTTTX3TTTTTXTTTTXTTT
T2TTTTTTTTT1TTT2TT3TTTTTTTTTTTT
TTTTTTXTTTTTTTTTXTTTXTT3TTTTTXT
TTXTTTTTTTTTTTTTTTXTTXT23TTTXTT
TTTTT3TXTTTTTTTTTTTTTTT2TTTTT3X
TTXTTTZTTTTTTTTTTZTXTTTXTTTTTTT
3TTTTXTTTTTXTTTXTTTTTTTTTTTTTTT
XTTTTTTTTTTTTTXTTXTTTT2TXTT3TTT
TTTTTTTTTTTTTXTTTTTTTTTTTTTTTT2
TTTTTTTTTTXTT2TTTTTTTTTTTTTTTT1
TTTTTTTTTXTTTTTTTTT1TTXTTTTTTXT
TTTTTTTTTTXTTTTTTTTTTXZXTTT3XT3
TTTT3TTTTTTTTTZTTT2TTT11TTTTTTT
TTTTTXTTTXTTTTT2TTTTTTTTTXTTTTT
TTTTTTTTTTTTTZTTTTTTTTTXTTTT1TT
TTTX1TXTTTTTTTTTTTXTTTTTTTTT1TT
TTTTTTTTTTTTXT1TTTTTTTXTT3TTTX1
TTTTTTTTTTTTTTTTTTTT1T1TTTTXTTT
TTTTT1TXTTX3TTTTXTTTTTXTTTTT3TT
ZTTTTTTTTTTTTTT3TTTTTTTTTTTTTTT
2TTTTTTTTTTTTTTTTTTTTTTTT3T1TTT
TTTTXTTXTXTTTXTTTXTTTZTTTTT2TTT
TTTTTT1TZTTTTTXTTTTTTTTTXTTTTTT
2X3TTTTTTTTTTTTTTTTTTTTTZXTTTTT
TXTTTT3TTTTTTTTTTTTTTTTTTTTTTT1
