WTTTTTTTTTTTTTTTTTTTTTTTTTTTTTTT3TTTTTT
3TTTTTTTTTTTTTTTTTTTXTTTTTTTTTTTTTTXTTT
T1TTTTTTTTTT1TTTTTTTTTXTTTTTTTTTZTZTXTX
XTTT2ZTTXTTTTTTTTTXTTTTTXTXTTTTTT1TTTTT
TTTTTTXT2TTTTTTTTTTTTTTTTTTTTTTTTTTTTTT
2TTTTTTTTTTTT1TTTTTTTTTTTTTTTTTXTTTTTTT
TT2TTTTTTTTTTTXXTTTTTTXXTZTTTTTTTTTXTTT
TTTTTTTTTTTTTTTTT2XTTXTTTTT1TTTTTTTTTTT
TTTTT1TTTTTTTTTT3T1T2TTTTXTTT2XTTTTTTT3
TTTTXTT3TTTTTTTTTXTTTTTZTTTTTTTTTTTTTTT
XTTT3TTTTTTXTTTTTTTTTTZTTXTTTT2TTTTTTTT
TTTTTTTTTXTTTTXTTTTTTTT3X3XTTTTTTTTTTTX
TTTXTTT1TTTTTTT21TTTTTTTTTTTTTXTTTTTTTT
TTXTTTTTTXTTTTTTTXTTTTTTTTTTTTTTTTTTTTT
TTZTTTTTT3TTTTTTTTTTTTTTTTTTTT3TTTZTTTT
TXTTTTTTTXTTTTTXTTTTTTXTTTTTTTTTTTTTTZ2
TXTTTTTTTTTTTTTTTTTTTTTTTXTTTTTTTTTTTXT
TTTTTTXTTTTTTTTTTTXTTTXTTTTXTTTTTTT2TTT
XTTTTTTTTTTTTTTTTTTTTTTTTT1TTTTTTTT1TTT
TTTXTTTTTTXTT1TTTTTTTTTXTTTTTTT3TTTTTTT
TTXTTTTTTTTTTTTTTTTTTTT1TTT1TTT2TTTTTTT
XTTTTTTT2TTTTTTT2TT2XTTTTTTTTTTTTTTTTTT
TZTTTTTTTTTTTTTTTTTTTTTTTTTT1TTTXTTTTTT
TTTXTTTTTT2TTTTTTTTTTTTTTTXTTTTTTTTTTTT
TTTTTTTTTTTTTTTTTTTTTT3TTTTTTTTTZTTTTTT
TTTTTTTTTTTTTTTT2TTXTTTTT2TTTXTTTTTTTTT
X1TTTT3TT3TTTTTTTTTTTTTTTTTXXTTTTTZTT13
3TTTTTTTTTTTTTT3TTTXTTTTTTTTTTTTTTTTTTT
TTXZTTTTTTTTTTXTTTT3TTTTTTXTTTTT3TTTXTT
TTTTTTTTT2TXTTTXTTTTTXTTTTTTTTTTTTT2TXX
TTTTTTTTTTTTTTTTTTTTTTTTTTTTTTTTTTTTTTT
TTTTTTTTTTTTTTT2TTTTT3TTTTTTTT3TTTXTTTT
TTTTTTTTT1TTTTTTTTTTTTTTTTXTTTTXTTTTTTT
TTTTTTTT3TTTTTTTTTTZXTT3TTTTTTZTTTTT1T3
TTTTT1TTTTTTTXTTTT3TTTTTTTTTTTTTTTTTTTT
TTTTTTTTZTTTTTTTTTTXTT2TTTXTTTTTTTTTTTT
TTXTTTTTTTTTTTXTTTT3TTTTTTTTTTTTTTTTXTT
TTTTTTTXTTTTXTT3TTTTTTTTTTTTTTTTTTTXTTT
TT11TTTTTXXTTXTTXTTTTTTXTTTTTTT2TTTTTTT
