WTTTTT2TTTTTTTTTTTTTT1TTTTTTTTTTTXTTTTTTTTTTTTT
TTTTT3TTTTT3TTTTTTTTTTTTTTTTTTTTTTXTTTTTTTTTTXT
TTTTTTTTTTTTTXTTXTTTTTTTTTTTTTTTXXT2TTTTTTTTXXT
TTTTTTTTTTTTTTTTTXTTTTTTT2TXTTTTTTTTTTTXT2TTTTT
TTTTTXTTTTTT3TTTTTTTTTTXTTTTTTTTTTTTTTTTT3TT21T
TTTTTTTTTTTTTTTTTXTTTTTXTTTTTTT12TTTTTTTTTTTTTT
TTTTTTTTTTTTTTTTTTTTTTTT2TTTTTTTTTTTTTTX3TTTT2T
TZTTTTTTTTTTTTTTTTTTTTTT3TXTXT3TTTXTTTTTTTX1TTT
TTTTTTTTTTTTTTTTTT1TT2TTTTTTTTTTT3TXTT2TTTTTTTT
TTTTTTTTXTTTTTTTTTTTTTTTTTTTTTTTTTTTTTTTXTTTTTT
TTTTTTTTTTXTTTTTTTTTTTTTT1TTTTTTTXTTTZTTTTTXTTT
T1TTTTTTXTTXTTTTXTTTTXTXTTXTTTZTTTTTTTTTTTTTTTT
TTTTT1TTTTTTTTTZXTX3TTTTTTTTTTTTTTTTTTTX1TTTZ2T
TTTTTTTTTTTTTTTT1TTTTTTTTTTTTXTTTTTTTXT1TTTTTTT
TTTTTTTTTTTTTTTZXTTTTTTTTTTTTXTXTTTTTTTTT1TTTTT
TTT3TTTTTTTT2TTTTTTTTTZTTTTTTTTTTTTXTXTTTTTTTXT
TTTTTTT2TTTTTTTTTTTTTTTTTTTTTTTTTTTTTTTTTTTTTTT
1TTTTT3XTTTXTTTTTXTTTTTTTTTTTTTTTTTTXTTTTTTTTTT
TTTTTTTTTTTTTTTT1TTTTTTTTTTTTTTTTTTT3TTTTTTTTTT
TTTTTTT3XTTTTTTTXTTXTXTZTTTTTTTTXTTTTTTT1ZTTTTT
1TTTXTTTTTTTT1TTTTTTTTTTT3T1TTTTTTTXXTTTTXTTTTT
TTTTTTTTT1TTTTTTTTTTTT3TTTTTTTTTTT2ZTTTTXTTXTTT
TTTTTTTTTTTTTTTTTTZTTTTTTTTTT2TTTTTTTTTTTTTTTTT
TTTTTTTTTTTTTTTTTXTTTTTTTTTTT2TTTTTTTTTTTTTTTTT
TTTTTTTTTTTTTTTTTTTTTTTT1TTXXTTTTTTTTXTTTTTTTTX
TTTTTTTTTTTTTTTTTTTTTTTTTTTZTTTTTTTZTTTTTTTTTTT
TTTTTXTTTTTTTTTTTTTTTTTTTTTTTTTTZTTTTTTTTTTTTTT
TTXTTTXTTT3TTTTTTTTTTTTTTXT3TTTTTTTTTTTTTTTZT1T
TTTTTXTTTTTTTTTTTTTTTTTT3TTXTTTTTTTTTTTTT3TT3TT
3TTTTXTTTTTXTTXTTTTTTTTTTTTTTTT1TTTTTTTTTTTZTTT
TTTTTTTTTTTTXT2TTTTTTTTTTTTTTTTTTTTTTTTTTTTTTTT
TTTTTTTTTTTTTTTTTT2TTTTTTTTTTTTTZT3TTXTTXTTTTTT
TTTTTTTTTTTTTTTTTTTTTTXTXTTTTTTTTTTT2TTTX1TTTTT
TTTTTTTTTTTTTTXTTTTTTXTTTTTTTTTTXTTTTTTTTTTTTTT
TTTTTTTTTTTTTTTTTTTTTTTTTTTTTTTTTTTXTTTTTTXTTTT
TTTTTTTTTTTTTTTTTTTTTXTTTT3TTTTTTTTTTTTTTTTTTTT
XTXZTTTTZTXTTTTTTTTTTXTTTTTTTTT2T1TTTTTTTTTXTTT
TTTTTTTTTT1T3TT1TTTTTTTTTTTTTT1TTTTTTTTTTTTTTTT
TTTTTTTXTTTT1TTTTTTTTTTXTTTTXTTTTT1TTTTT1ZTTTTT
TTTTTTTTTTTTTTTTTTTTTTTTTTTTTTTTXXTTTTTTTTTTTTT
TTTTTTT2TTTTTTTTTTTTTTTTTTTTT3XTTXTTTTTTTTTTTTT
TTTTTTTTTTTTTTTTTTTTTTTTT3TTTTTTTTTTTTTTTTTTTTT
TTXTXTTTTTTTTTTXTTTTTTTTTTTTTTTTTXTTTTTTTTTTTTT
TTTTTTXTTTTTTTTTTTTTTTTTTXTTTTTTTTTTTTTTTTTTTTT
TTTTTTTTTTXTTTTTTTTTTTTTTTTTTTTTTTTTTTTTTTXTTTZ
TTTTTTTTTTTTTTTTTTTTTTTTTTTTTXTTTTT1TTT1TTTTTTT
TTTT3TTTTTTTTTTTTTTTXTX1TTTTTTTTTTTTTTTTTZTTTT3
