WTTXTTTTTTTTTTTTTTTT1TTXT2TTZTTTTTTTTTTTTTTTTTTTT
TTTTTZTXTT3TTTTTTTTTTXTTTTTTTTTTTTTTTTTTTXTTTTTTX
2XTTTTTTTTTTTTTTXTTTTTTTTTTTTTTTT1TTTTTTTTTTXTTTT
TTTTTTTTTTTTTTTTTTTTTTTTTTTTTTTTTTTTTTTXTXTTTTTTT
TTTTTTTTTTTTTT1ZTTTTTTTTTTTT2TTTTTTTTTTTTTTTTTTTT
TTTTTXTTT3TTTTXTTTTTTTTTTXTTXTTTZTTTTTTTTTTTTTTTT
TTTTTTTTTTTTTZTTTTTTTTTTTTXTTZTTTTTTTTTTT1TTTTTTT
XTTTTTTTTTTTTTTTTZTTTTTTTTTTTTTZTTTTTTTTTXTTTTTTT
TTTTTTT1TTTTTTTXTTTTTT1TXTXTT1T3TTTTTTTXTTXTTTTTT
TTTTTTTTTTTTTTTTTTTTTTTTTTTTTTTTTTTTTZTTTTTTT1TTT
TTTT1TXTTTTTXTTTTTTXTTTTTTTT2TTT3TTTTTT3XTTTTTTTT
TTT2TTTTTTTTTTTTTTTTTTTTTT23TTTTTTTTTTTTTTTXTTTTT
TTTTTTTXTTTTTTTTTT1XTTTTTTTTTTTTTTTTT2TTTTTTTTTTT
XTTTTX1XTTTTTTTTTTTTTTT3TTTTTXTTTTTTTTXTTTXTTTTTT
TTTTTT3TTTTTTTTTTTTTTTTTTTTTTTTTTTTTTTTT2TTTTTTTT
TTTTTT1TXXTTXTTTTT1TTTTTTTTTTTT2TTT2TTTTXTTTTTXTT
TTTT3TTTTTTTTTTTTTTTXTT32TTTTTTTTTTTTTTTTTTTTTTTT
TTTTTTTTTTTTTTZTTTTTTTTTTTTTXTTTTTTTTTTTTTT3TTTTT
TXTTTTTTTTTT1TTTTTTXTTTXTTTTXTTTTTTTTTTTTTTTTTTTT
TTTTTTTTTTZTTTTTTTTTTTTTTTTTTTTTTTTTXT1TTTTTTTTTT
TTTTTXTTTTTTTTTTTTTTTTTTTTTT2TTTTTTTTTTTTTTTTTTTT
TTTT2TTTXTTTTTTTTTTTTTT1T3T3TTT1TXTTTTTTTTTTTTTTX
TTTTTTXTT1TZTTXT1TXXTTTTTTTTTTTTTTXT1TTTZXTTTTTTT
TTTTXTTXTTTTTTTTZTXTTTTTTTTTTTTTZTTTTTTTTTTTTTTTT
TTTTXXTTTTXT11TTTTTTTTTTTTTTTTTXTTTTTTTT1TXTTTXTT
TTTTTTZTTTTTTTTTTTTXX3TTTTTTTTTTTTTTTT1TTX2TTTTTT
TTTTTTTTTTT3TT3TTTTTTTTTT3TTTTTTXTTTTTTTTTTTTTTTT
TTTTTTTTTTTTTXTTTTTTTTTTTTTTTTTTTTTTTTTTTT3XTTTTT
TTTTTT2TTTTTTTTTTTTTTTTTTTTTTTTTTTTTTTTTTTTTTTTTT
TTTTTTTTTTTTTTTTTTTTTTTTTTTTTTTZT2XTTTTTXTTTZTTTT
TTTTTTTTTTTTTTTTTTTTTTTTTTTXTTTT3XTTTTTTTT2XTTTTT
TTTTT3TTTTTTTTTXTTTTTTTXTTTTTTTTTTTX2TTXXTTTTTTTT
TTTTTTTTTTTTTT21XT32TTTTTTXXT2TTTTTTTTTTTTTTTTTTT
ZTTTTTTTTTTTTXTTTTTTTTT2TTTTTTTTTXTTTTTTTTT3TTTTT
TTTTTTTTTXTTXTTTTTTTTTTTTTTTTTTTTTTTXTTTTTTXTTTTT
TTTTTTXTTTTTTTTTTTTTTTTTTTTT1TTTTTTTTTTTTTTTXT2TT
TTTTTTTTTTTTTTTTTTTTTTTTTTTTTXTTTTTTTTTTTTTTTTTTT
TTTTTTTTTTTTTTT3TTTTTTTTTTTTZTT3TTTTTTTTTTTTTTTTT
TTTTTTTTTTTTTTT3TTTTTT1XTTTTTTTT3TTTTTTTTTTTTTTTT
TTTTTTTTTTTTTTTTTTTXTTTTTTTTTTTTTTTTTTTTTTTTTTTTT
TTTXTTTTTTTTTTT2TXTTTTTTTTTTTTTTTTTTTTTTTTTTTTTTT
TTTTTTTTTTTTTX3TTTTTTTTTTTTTTTTTTT1TTT2TTTTT1T2TT
TXTTTTTTTTTTTTTTTTTTTTTXXTTTTTXXTTTTTTTTTTTTTTTTT
TTTTTTTTTTTTTTTTXTTTTTTXTTTTTTTT2TTTTTTTTTT2TTTTT
TTTTTTTTTTTTTTTTXTTTTT1TTTTTTTTTTTTXTTTTTTTTTTTTT
TTTTTTTTTTTTTTTTTTTTTTTTTTTTTTTTTTTTTTTTTTTTTTTTT
TTXTTTTTXTZTTTTTTTTTTXTTTTTTTTTTXTTTTTTTTT2TT2TT3
TTTTTTTTTTTTTTXTTTTTTTTTTTTTTTTTTTTTTTTTTTTTTTTTT
TXTTT11TTTTTTTXTTTTTTTTTTTTTTTTTTTTTTTTTTTTTTTTTT
