WTXTXTTTTTTTTTTTTTXTTT1TTT
TT1TTTXTTTTTTTTTTX1TTTXTTX
TT2TTTTTTTXTXTTTTXX2TT3TTT
TT2TTTTTTTTTTTTTTTTT3T3TTT
XXTTTTXXTTTTTTTTTTTT1TTTTT
T3TTTTXTTXTTTTTTTTTTTTTTTT
TTTTTTTXTTTTTTTXTTTTT2TTTT
TTTTTTTTXT1TXTTTXTZTTTZXTT
XTTTTTTTTTTTTZTTTT3XTTTTTT
3TTTT2XTTTTTTTTT2XXT1TTTTT
TT2TTXXTTTTTTT3TTTTTTTTTTT
TTTTTTTTTTTTTTTTTTTTTT3TTT
T1TTTTTTTTT2TTTTTTTTTTTXTT
TTTTTT13TTTTTZZTTTTZTTT1TT
2TTTTTTTTTTTTXTTTTTTTTZTTX
T1TTTTTTTXTTTTTTTXT1TTT3TT
TT1TTTXTTX2TTTTTTXTTTTTTTX
XTTTT1ZTT2TTTTTTTTT1TTT1TT
TTTTTTTTTTTTTTTTTTTTTTXTX2
TTTTTTXTTTTTTTTTTTZTTTTXT3
ZTTTTXTTXTTTXTT2TTTXXTTTT3
TTTTTTTTTTZTTTTTTTT1TTTTTT
TTTTTTTTTTTXXTTTTTTXTTTTTX
TTTTTTTTTXTTTTTTTTTTTTXTTT
TTTTTTT3TTTTTTTTTTTTTTTTTX
TTXTTZTTTTTTTTTTTTTTTX2T3T
