WTXXXTTT2X
TTTTTTTTT2
XTTXTTTT3X
XTTTZTT2T1
TTZ1TTTTTX
1XZX1TTTTT
TT3XZT1TTT
T22TTXXTTX
TTTTTTTTTX
XXXTTX2TTT
