WTTTTTXT3XTXTTTTTTTTTTTT2TTTTTXTTTT
TTTTTTTTTTTTTTTXTTTTZTTTTTTTTTTTTTT
TT222TTTTTTTTTTT3TTTTTXTTTXXTTT3TTT
TTXTTTTX1TTTTTTTXTTTTTTTTTTTTT32TTT
TTTTTTXTTTTTTXXTTTTXXTTTTTTTTTTTTTT
TTTTTTXTTTTTTTTTT12X1TXT1T2TTTTTTTX
TTTTXTTTTTTTTTT3TTTTT1TTTTTTTTXTTT1
TTTT2TTTTTXTTZTT1TTTZTTTXTTTTTTTTTT
TTTTTTTTTTTTTTTT1TTTTTTTTTTTTTTTTT1
TTXTTTTTTTT1TTTTT2TTTT2TTTTTXTTTXTT
TTTTZTTTTTTZTTTTTTTTTTXTTTTTTTTTTTT
XTTTTTTTTTTTTTTTTTTTTTXTTTTTTTTTTTT
TTTTT1TTTTTTTTTTTTTTT1TTTTXTTTTT3TT
TTT2XTTTTTTXTTTTTXTT3XTTTTTTTXTXZTT
TTTZTTTXTTXTT2TTTTTTTT1TTTTTZTTTTZT
2TTTTTTTTTTTTTTXTTTTTTTTTTTTTTTTTXT
TTTXTTTTTTTT31TTTTTTTTZTTXTTTTTTTTT
TTTTTTTT3TTTTTTT1TTTTXTTTTTTTTTTTTT
TTTTTTTTT2TTTXTTTT1TTTTT2TTTTTTTTXZ
TTTTTTTTTTTTTTTTTT3XT2TTTTXTTTTTT3T
TTTTTTTTTTTTTTTT1TZTXTTTTXTTTTTTTTT
TTTTXZTTTTTTTTTTTTTXTT2TTTTTTTTTTTT
TTTTTTT3TZTTTTTTXTTTT1TTTTTTTTTTTTT
XTTTT2TTTTTTTTTTTTTTTTTTXTTTTTTTTTT
1TTTTTTTTTTTTTTTTTTTTTTTTTTTTTTTTTT
TT2TTXTTXTTTTTT1TTTTTTTTTTTTT3TTTTT
TTTTTTTTTTTTT2TTT1TTTTTTTTTTTT3TTTT
TTTTTTTTTXTTTTTTTTTTTTT2TTT3XTTTTTT
TTZTTXTTTTTTTTXTTTTTT3TTTTTTTTTTTTT
TTTT1TTTTTTTTTTXTTTTTTTXTTTTTTXTTTT
TTTTTTTTTTTTTXTTTTTXTTTTTTXTTXTTTTT
TXT3TTTXTTTTTTXTTZTTTTTTTXTTTTTTTTT
TTTTTTTTTTTT2XTTXTTTTTTTTTTTTTT3XTT
TTTTTTTTTTT2TTTTTTTTTTTTTTT2TTXTTTT
TTTTTTTTTTTTTTTTXTTTTTTXTTTTTTTTTTT
