WTT2TTT31TTTTTTT
TTXXTTTXXT2TT2TT
TT3TTTTTTTTTTT3T
TTXTTTTXTTTTTTXT
TTTTTTTZTTTTXTTT
TTTTTTTTTTTTTTTX
XTXX1TTTT1TXTT2T
TXXTXZTTTTTTXTTT
TZTTT3TTTTXT2TTT
TXTTZTTTXXTTT2TT
TTTXTXTTTTT2TTXT
TTTTTTTTTTTTTTT3
3TTTTTX2T3T3TTTT
T3ZTXTXTTTTXZT1X
TTTXTTXTTXTTTTTT
3TT1TTT3TTTTTTTX
