WTXTT1TXTTZT2T3TTTXTTTTTTXTTT2TT
TTTTTTTTXZTTXTTXT2TTTXTTTTTTTTTT
TTTTTTTTTTXTTXTTTTTTT1TTTTTT3XXX
T31TTTTZTTTTXTZTTTTTTTTTTTT1TTTT
TTTTTTTTTTXTTTTTTXTTTTTTTTTTTTT1
TTTT3TTTTT32XTTTTTTTTTTTTT1TXTTT
TXTTTTTTTTTTTTTTTTTTTTTTTTTTTTTT
TTTXTTTTTTTTTTTTZTTTTTTTTXTTT3TT
TTT2TTTTTTTTTTTTTTTTT3TXTTTTTTXT
TTTTTTXTT1TTTTTTTTTTTTTTTTZTZTTT
TTTTTTTTTTTTTTTXT3TTTTTTTTTTTTT3
TTTTTTTTTTT1TTTTXTTTTTTTTTT33TTT
TTTTTTTT3TTTTTTTTTTTTTTTTTTTXTTZ
TTTTTTTTTTTXTTTTTTTTTTTT3TT1TTTT
TTTXTXTTTTTXT2TTXTTTTZTXTTTTTTTT
T2TTTTTTT3TTTXTT3TTTTTZ1TTTTTTTT
TTT3TTTTTTTTTTTTTTTTTTTTTTTTTTTT
TT1TTTT3TTTTTTTTTTTTTTTTTTTTTTTT
TXXTTTTTT1TTTTTTTTT23TTTTTTTT1TT
TTTTT1TTTTTTTTTTTTTTTXTTTTTXTXTT
TTTTTTTTTTTTTTTTTTTTTTTTTT2TTTTT
TTTTTXTTXTTTTTTTTTTTXTXTTTTTXTTT
TTTTXTTT1TXXTZTTTTTTTTT1TTTT2TXT
TTTTTTTTTXTTTTTTTTTTTTXTZTTTTTXT
TTTT12TTTTTTTTTTTXTTTTTTXTTTTTTT
TTTTTTTTXXTT1TTTTTZTTTTTTTTTTTXT
TTTTTTTTTTTTTT1TTXTTTTT1XXTTT21T
TTTTTTTTTTTTTTTTTTXTTT1TTTTTTZTT
TXTTTTTXTTTTTTTTTTTTTTTTTX2TTT2T
TTXTTTTTXTTTT2TTTTTTTTTXTTTTTXTT
TT2TTTTTTXT3TTTTTTTTXTTTTTTTTTTT
XTTTTXTTTTTTTTTTTXTTTTTXTTTTTTXT
