WTXTTTTTTTT2XTTTT3TTT3T2TTXTTTT3T
TTTTTTTTTTTTTTTTTXTTTXTTTXTTTTTTT
TXTTTTTTTTTTTTTTTTTTTTT1TTTTXTTTT
TTTTTTTT3TTTTXTTTTTTTTXTTTTTTTTTT
TTTT2TTTTTTTTTTTTTTT1TTTTTTTTTTTT
TXTTTTTTTTTTTTTT3TTTTTTTTTTTTTTTT
TTTTTTTTTTTTXTTTTTXTTTTTTTTTZTTT2
TTTTT3TTZTTTTTTTTTTTTZTXTTTTTTTZT
TTTTT2TTTTTTTTXTTTXTTTTTTTTTTTTTT
TTTTTTTTTTTTTTTTTXTTTTXTTTTTTTTTT
X2TTTTTTTTTTTTTTTT3TTTTTTT2TTXTTX
TXTXTTTTTTTTTT1TTTTTT2TTTTXTTTXTT
TTTTTTTTTXTTTTTTTTTTTXTTTTTT1TTTT
TTTTT2TTTTTZTTTXTTTTTTTTTTXTTTT3T
TT1TTTTTTTTTTTTTXTXTT3TTTTTTTTTTT
XTTTTTTZTTTXTTTT2TTTTT1TT1TTTTTTT
TT3TX1TTXTTTTTTTTTTTTTTTXTTTTT3TT
T2T2TTXTX33TTTTTTTTT2TTTXTTTTTTTT
TTTZXTTTTT1TTTTTTXT21TTTTTTTTTTTT
TTTTT3XTT1TTTTTXTTTTTTTTTTXTXTTTT
TTTTTTTTTTTTTTTZTTTTTTXTTXTTTTTTT
TTTTTTXTTT3TTTTTTTTTTTTTTTTTTTT1T
XTTTXTTXZTT3TTTXTXXTTTT13TTT3TTXT
TTTTTX2TTXTT3TTTTTTTTTTTTTTTTTTTT
TTTXTTTTTTTTTTTTTTTTTTTTTTTTZTTTT
TTTXTTT22TTTTTTTTT1TTTTTTXZT3TT2T
TTTTXTTTTTTTTTTTTTTTXTTTTXTTTTTTX
TTTTTTTTTTTTTTTTTTTTTTT2TTTTTTTTT
TTXTTTXTTXTTTTTTTTTTTTTTTTXXTTTTT
TTXTTXXTTTXTTTT2ZTTTT3TT2TTTTTT1T
TTTTTTTTZTTTTTTTTTTTTTTT2XTTTTTTT
XTXTTTZTTTTTTTTTTTTTTTTTTTTTTTTTT
TTTTTTTTTTTTTXT3TTTTTTTTTTTTTTTTT
