WTT1TXTTTTXTTTX2TT
T1TTT22TTTZTTTTTTT
TTT2TZTT3TTTXTXZTT
TTT1TXTTTTXTTTXTTT
TTT1TTTXTTTTT1TTTT
TTXTTTTTTTTTTTTTTX
XT3XTTTTTTTTXTTXTT
TXTTTTTTT1T3TTTTXT
TTXTT1TTTXTTTTZT3X
TTTTT3TTTT2XTT3TTT
TTXTTXTTTZ2TT2TTTX
TTTTZTTTT2TTT1TTTT
ZXTTZTTTTTT31TTTTT
T2TTTXTTTT1TTTTTTT
TTTTTTTTXTTTTTXTTT
XTTT1TT1TTTXTTTT1X
TTTTTTTTX1TXTTTTTT
TTXXTXXTTTX1TXTTTT
