2TTTTTTTTTTTTTTTTTTTTTTT
TTTTTT1TTTT1XTTTTTTTTTTT
1TTT2TTTTTTTTTTTTTTT1TTT
TTTTTTTTTTTTZ2TTTTXTTTTT
1T1TTTTTTTTTTXTTT1T1XTXT
2TTXTTTXTTX1TTT1T3TTTTTT
ZTTTTTTTXXTTT3TTTTTTZTTT
TTTTTTTTTTTTTTTTTTTTTTTT
XTTTT2TTTTTTXTTTXTTTTTTT
TTTTTTXTTTTTTTTTTTTTTTTT
T1TXTTTTTTTTTTTTTTTTXTTT
2TT1TTTTTTT3TTTTTTTTTXTT
TTTXTTTTTTXTTTTTTT3X2TTT
XZTTXTTTTTTTTTTT2TTTTZTT
TTTTTTTTTXXTTTXTTTXXTTTT
TTTTTXX1TTTXTTTTTTTXTTTT
T1T1TTTTTXXTTTTTXTTTTT2T
TTTTTTTTTTTTZTTXTTTXTTXT
2TTTTTTTTTZXTTTT1ZTTTTTT
TTT2TTTTT2TTTTXTTTTTTTTT
XTTTTTTTX2TTTTTTXTTXTX1T
TTZTXTTTTTTTTTTTTXTTTTTT
XTXXTTZ3TTTTTXTXTTTTTXTT
TTTT3TTTT2TTTXZXT1TTTTXT
