WTTTTTTT1TTTTTTT3
TX1TTZTTTTTTTTTXT
X1TXTTZTT1X1TTTTT
TXTTTTXTTTT1TTXTX
XTTXTXTTTTTTTT2T2
TTTTTX31TXXTTXTTT
T3T3TTTTTTTTT12XZ
XT1TTXTTTT3T2TTTX
TTTTTTTXTTTTTTTTT
TT2TTTTTTXTTXTTTT
TTTTXTTTTTTTTTXTX
TTT3TTXX3TTZTTTTT
TTTTTTT33TTXTZTTT
TTTXXTTTTTTTTXXTT
TTTZTT2TTTTTTTTTT
1XT13TTTTTTTTTTTT
TTXTTTTTTTTXTTTTT
