WTTTXTTTTTTTT
TXXXXTZZTTTTX
TTTTTTTT3TX2T
TTXTT2X3X1TTX
TTTTTT2TTXXT3
TTTTTTT2TTTXX
TTTTTTTXTTTTT
TTTXXTTTTTTXT
TTXTT2TT1X3T2
2TTTXTTTTTTT3
TT21XTTTTTT11
TTTTTXZZ2TTTX
TTTTTTTXX3ZT2
