WXXTTTTTTTTTTTTTTTTZTTTXTTTT
TTTTTTTTTTTT1TTTTTTTTTTTTTXT
TTTTTTTTT2TTTTTXTTTTTTTTTTTT
TTTTTTTTTTTTXTXTTTTTTZTZTTTT
TTTTTTTTTTTTTTT1TTTTTTTTTTTT
TTTTTTXTT1TTXTTTTX3TXTZXZXTZ
XTXT2TXTT3TTTTTTTTTXTXT3TTTT
TTTTTXTTTTTXTTTTTTTXXTTTTTTT
XTTTTTTTTTZXTTTXTTTTTTTTTTTT
TTTTTTTTTTTTTTTTTTTTTT2TTTTT
1TTTTTXTTTT2TTTTTTTTXT2TTTXT
TTTTTTT32XT1ZTXTTTTTTTTTTTTT
TT3ZT2TTTTTTTTTTTT3TT3TTTTTT
XTTTTTTTTTTTT2TTTTTTTTTTXTTT
TTTTTTTTXTTTTTTTTTXTTTTTTTTT
TTTTTT3TTTT1TTTTXTTT3TT3XTTT
TTT3TTTTT1TTTTTXTTT3TTTTTTT2
TTTTT2TTTTTTTXXTTZTTTTTTTTT3
XTTTTTXTTTTTTTTTT1TTTTTTTT3T
TTTXTTTTTXTTTTXTTTTTTTTTTTZT
XTTXTTZTXTTXT2TTTTTTTTXTZTTT
1T3TX1TT1T1TTTTTTTT3TTTTT1TT
TXTTTTTTTTTTTTTTTTTTTTTTTT1T
2TTTTTTTTTTXT3TTTTTTXTZTTTTT
TTTTTTTTTTTTTTTTTTTTTTTTTTTT
TT3TXXTTTTTTTTTTTTXTTTXTTTTT
3TTTTTTTXTTTTTTXTTXTXT3TTTTT
TTTTTTTTTTXTTTTTTXTTTXTTTTTT
