WTTT3TTTTTTTTTTTTTTTTTTTTTTTTTTTTTTTTTTTTTTTTT
TT3TTTTTTTTTTTTTTTTTTTTTXTTTTTTTTTTTTTTTTTTTTT
TTTTTTTTTTTTTTTTTTTTTTTTTTTTTTTT2T2TTTTTTTTXTT
TTTTTTTTTTTTTTTTTTTTTTTTTTTXTTTTTTTTTTT2TTTTTT
TTZXTTTTTTTTTTTTZTTZTTTTTTTTTTTTTTTTTTTTTTTTTT
TTTTTTTTTTTTTTTTTT22TTTXTTTT2TTTTTTTTTTTTTTTTT
1T3TTTTTTTTTTTTTTTTTTTTTTTTTTTTTTTTTT2TTTTTTTT
TTTTTTTTTTTTTTTTTTTTTTXTTTTTTTTTTTTTTTTTTTTTTT
TTTTTTTTXTTTTTTXT1TTTTTTTTTTTTXTTT2XTXTTTXTTTT
TTXTTTTTTTTTTTTTTTTTTTTTTTTTTTTTTTTTTTTTTTTTTT
TTTTTTTTTTTTTTTTTXT2TTTTTTTTTTTTTZTTTTTTTTTTTT
TTTTTXTTXTT1TTTTTTTTTTTTTTTTTTTTTTTTTTTTTTTTTT
TTTTXTTTTTXTTTTTTTTTTTTTT1TTTTTTTTTTTTTTTTTTTT
XTXTTTTTTTTTTTTTTTTTT2TXTTTTTTTTTTXTXTTTTXTTTT
TTTXTTTTTTTTT2TTTTXXTTTTTTTTTTTXTTTTTTTTTTTTTT
TTTTTTT2TZTTTTTTTTTTTTTTXTTTTTTTTTTXTTTT3T2T3T
TTTTT1TTTTTTTTTTTTTTXTTTTTXTTTTT3TTTTTTTTTTTTT
2TTTTTTTTTXTTTXTTTZ1TXTTTTTTTTT2TTTTTTTTTTTTTT
TTTXTZTTTTXTTTTTTTTTTTTTTTTTTTTTTTTTTTT13XTT1T
TTTTTTTTTTZ2TT2TTTTTTTTTTXTTTTTTTTTTTTTTTTTTTT
TTTX3TTTTTTTTTT2TTTTTTT2TTZTTTTTTTTTTTTTTTTTTT
TTTTTTXTTTTTTTTXTTTTT3TTTTTTTTTTTTTTZTTTTTTXTT
TTTTTTTTTTTTTTXTTTTTTTTT1TTXTTZTTTTXTTTTTTTTTT
TTTT3TTTTTTTTTTTTTTTTTTTTTTTTTTTTTTTTTTTTTTTTT
TTTT2TTTTTTTTTTTT2TTTTTTTTTXXTTTTTTTT3TTTTTTTT
TTTTTTT1TTTTXTTTTTTTTTTTT3TTTTTT1TTTXTTTTTTTTT
TTTTTTTTTTTTTTTTTTTTTTTTXTTTTTTTTTTTTTTTTTTTTT
XT2TT3TTTTTTTTTTTTTTTTTTTTTTTTTTTTTTTTTTTXTTTT
TTTT3TXTTTXTTZTTXTTTTTTTTTTTTTTTTXTTTT1TTTTTTT
TTXTTTTTTTTTTTTTTXTTTTTZTTT1TTZTTTTTTTZTTXTTTT
TTTTTTTT1TTTTTTTTTTTTTTTXTTTTTT1TT2TTTX2XTT3TT
TTTTTTX1TTXTTTTTTTTTTTTXTTTTTTTXTTTTTTTTTTTT32
TTTTTTTTTTTTTTTTTTTXTTTTTTTTTTTTXTTTTT2XTTTXTT
TTT2TTTTTZTTTTTTTTTTTTTTTTTT1TTT1TTXTTTXTTTTTT
TTTTTTTTTTTTTTTTTTTTTTTTTTTTTTTTTTT3TTTTTTTTTT
TTTTTTTTTTT3TTTTT1TTTTTTXT3TTTTXTTTTTTTTTTTTTT
X1TXTTTTTTTT3TTTXTTTTTTTTTTTTTXTTTTZT1TTTTTTTT
TTTT2TTTTTTTTTTTTTTT2TTT1TTT2XTTTXTTTTTTTT3TTT
TTTTTTTTXTTTTTTTTTTTTTTTTTTTTTTTTTTTTXTTTTTTTX
TTTTZ1TTTTTTTTTTTTTTTTTTTTTTTTTTTTTTTTTTTTTTTT
TTTXTTTTT2XTTTTTTTTTTTTTTTTTTTTTTTTTTT2TTTTZTT
TTTTTTTTTTTTXXTTTXTTTX2TT1TTTTTTTTTTTTTTTXTTTT
TXTTTTTTTTTTTTTTTXXTT2TTTT2TTTTTTTTTTTTTTTTTTT
TTTTTTXTXTTTTTTTTTTTXXTTXTTTTTTTTTXTTTTTTTT31T
TTTTXTTTT33TTTTXTTTTTTTTTTXTTTTTXTTTTTTTZTTXTT
TTTT2TTTTTTTTTTTTTTTTTTTTTTTTTXTTTXTTTTTTTTTTT
