WXTTTTZT1TTTZTT
TTTTT2TTT3TXTTT
TXTZTTTZZTTTTXT
X3TXTXTTT2TT2TT
TTTTXTTXTTTTT12
TTTXTTTTTTTTTTT
3TTTTTXXTTTTXTX
XTXTXTX23Z1XTTT
2TZ3TTTTTT1TTTT
TTT2TTTTTTTTTTT
1XTTT2XTTTTXXTT
TTTTTXTTT3TTTXT
TXXTXTXTTTTTTTT
TTXTTTTTT1TTTX2
TTTTT3TTTTTTT3T
