WTTTTTTT3TTXTTTTTT1TXT
TTTTTTTTTTTTTTTTTTTTTT
TTTTTTXTTTTTTT2TTTTTTT
TTTTTXT2TTTTTXTTTTTXTT
XT3TTTXTTZT3TTTTTTTTXT
TTTT2TTTXTTXTTXTTXTTTZ
TTTTXXZ2TTT2T3ZTT3TTTX
TTTTTTTXTTTTXT1TTTTTTT
TTXXTT2XTTTTTTTTTTTTTT
TTTTTTTTTXTTT31ZTTTTXT
XTTTTTTTT3XTT3TTTTZTTX
TTZTXTX1XTTTTT2TXTX2TT
ZTTT1TTT3TTTTTTTTX2TTT
TTTTT3TTXXXTTTT2TXTTTT
X1TTTTXTTTTTTTTTTTTTTT
T1TTTTTTTTTTTTTTTTTTT1
3TZTTTTTTTTTTT1TTT1TTT
3TTTTTTTTTTXTTTTTTTTXT
T1TTXTTTTX1TTTTTTTXTXT
XTTTTTTT3TTTTTTTTTTXTT
TTTXTTTTTTTTTTTTXTTTTT
TTTTTTTTTTTTTTTXTTTTTT
