XTTTTTTTTTTTTTTTTTTTTTTTTTXTTTT2TTTTT2TTT
TTTTTTTTTT2TXTTTTTTTTTTTTTTTTXTTTTTT2TZTT
TTTTTTTTTTTTZTTTTTTTTTTTTTTTZTTTTTTTTTTTT
XTTTTTZTTTTTTTTTTTXTT3TTTTTTTT2XTTTTTTTTT
TTTTTTTTTTTTTT13T3T3TTTTTTTTTTTTTTTTTTTTT
XXTTTTTTTTTTTTTTTT1TTTTZTTTTTTTTTTTTZTTTT
TTTTTTTXTTT3TTTTTTTTTTTTTTTTTTTXTTTTTTTTT
TTTTTTT1XTTTTTTTTTTTTTTTTTTTTTTTXTTTTTTTT
TTTXTZTTTTTTTTTTTTTTTTTTTTTTTTXTT3TTXTTTT
TTTTTTXTTXTTTTTTTTTTTTTT21TTTTXTTTTTXTTTT
TTTTTTTTTTTTTTTTTTTTTTTTTTTTTTTTTTTXTTXTT
TTTTTTXTT1TTTTTTTTTTT2TTTTTTTZTTTTTTTTTTT
TTTTTTTTT3TTTTTTTTTTTXTTZXT2TT3TTTTXTTTTX
TTTTTTTTTXTTTTTTTTTTTTTTT2TTT1XTTTTTTTTTT
TTTTTTTTTTTTTTTTTTTTTZ3TTTXTTTTTTTTTTTTTT
XTTTT2TTXTTTXXTTTTTTTTTTXTTTTTTTTTTTX3TTT
TTTTTT2TTTTXTTTTTTTTTTTTXTTTTTTXTTXTTTTTT
TTTTTXTTTTXTT1TTTTTTTTXTTTTTTTTTTT1TTTTTT
TTTTTTTTTTTTTTTTTTTTTTXTTTTTTTTTTTTT3T3TT
TTTTTTTTTTTTTTTTTTTTTXTTTXTTTTTTTZXTTT3TT
TTTTTTTTTT3TTXTTTTZTTTTTTTXTTTTZXTTZTTTTT
TTTTTTZTTTTTTXTTTTTTTTTTTTTTTTTTTTXTTTTTT
TTTTTTTTT1XTTTTTTTXTTTTTTXTTTTTTTTTTT1TTT
TXTTTTTTTTTTTTT2TTTT1TZTTTTXT2TXTTTTTTTTT
XTTTTTTTTTTTTT2TTTTTTTTT2X3TTTTTTTTTTTTTT
TTTTTTTTTTTTTTTTTTTTTTTTTTTTTTTTTTTTTTTTT
TTTTTTZTTTTTTTTTT2TTTTTTTTTTXT1TTTTTTTTTT
TTTTTTTTTTTTTTTTT3TTTTTTTTTTTTTTTTTTTTTTX
TXTTTTTTTTTXTTTTTTTTTTTTTTTTTTTTTTTTXXTTT
TTTTTTXTTTTTTT1TTTTTTT3TTTTTTTTTTTTT2TTXT
TTTTTTTTTTTTTTTTTXTTTT3TTTXTTTTTTTT23TTTT
TTTTTTTT2TTTTTTTTTTTTTT3TTXTTTXTTT2TZTX1T
TTTTTTTTTTTTTTTTTTTTTTTTTTTTTTTTTTTTTTTTT
3TTTTTTTT1XTTTTTXTTTTTTTTTTTTTTTTTTTTXXTX
TTTTTTTT1TT2TTTTTTTTTTTTTTXTXT1TTXTTTTTTT
TTTTTTTTTTTTTX2TTTTTTTTTTTTTTTTTTTTTXTT3T
TTZTT2TTXTTTTTTTTTTTTXTTTTTZ33TTTTTTTTTTT
TTTTTTTTTTTTTTTTTTTTTTTTXTTTTTTTTTTTT2TT2
TTTTTTTTTTTTTTT3TTTTTTTTTTTTT3TTTTTTTTXTT
XTXT1TTXT3TTTTTTTXTTTTTTTTTTTTTTTTTTTTTTT
TTTT3TTTTTTTTTTTTTTTTTTTTTTTT2X2TTTTXTTTX
