WTTTTTTTTT3TTTTTTTXTTTTTTTTXTTT1TTTTTTTTTT3XTTT3
TTTTTTTTTTTTTTTTTTTTTTT3TTTTTTTTTTTTTTTXTTTTTTTT
TTTTTTTTTTXTTTTZTTTTTTTT2TTTTTTTTTTTTTTTXTTTTTTT
TXTTTTTTTTTTTTTTTTTTTTZTTTTXTTTTTTT2TTTTTTTTTTTT
TTTTTTTTTTTTTTTTXTTTTTTTTTTTTTTTTTTTT2TTTTT3TTTT
TTZXTTTTTT2XTTTTTTXTTTTTXTTTTT2TTTXTTTTTTTTTTTT3
XTTTTTTTTTTTTTTTTTTTTTTT2TTTTTT1TTTTTXTTTTXTTTTT
TTTTTTTTTTTTTTTTTTTTTTTT1TTTTTTTTTTTXT1TZTTTTTXT
TTXTTTTTTTTTTTTTTTTTTTTTTTXTTTTXTTTTTTXTTTTTTTTT
TXTTTTTTTTTTTTTT3TTTXTTTTTTTTTTTTTTTTTTTTTTXTTTT
XTTTTTT3TTTTTTTTTTT3TXTTTTTZTTTTTTTTTTTTTTTTTTTT
TTTTTTTTTTTTTTT3TTTTTT2TTTTTZTTTTTTTTXTTTTTXTTTT
TTTXTTX1TTTTTTTTTTTTTTTTTTTTTXTTTTTTTTTTTTTTTTTT
TTTTTTTTTTTTTTTTTTTTTT1TTTTTTTTTXTTTTTTXTTT2XTTT
TTTTTTTTTTTTTTTTTTTTTTTTTTTTTTTTXTTTTXTTTTTTTTTT
XTTTTTTTT1TTTTTTTTTTTTTTTTTTTTTTTZTTTZTTTTTTTTTT
TTTTTTTTTTTTXTTTTTTTTT2TTTTTTTTTTTTTTTTTTTTTZTTT
TTTTTTTTTTTTTTTTTZTTTTTTTTTTTTTTTT2TTTT11TTTTTTT
TTTTTTTTTTT3TTTTTTTTTXTTTTTT2TTTTTTTXTTTTTTTTTTT
TTXTTTTTTTTTTTXTTTTTTTTTTTTTTT2TTTTTTTTTTTTTTTTT
3TTTTTTTTTTTTTTTTTTXTTTT2TTTTT3TTTTTTTTTXTTTTTTT
TTTTTT3TTZTTTTTZTTTTTTTTTTT2TTTTTTXTTTXTXTTTTTTT
TTTTTTTTTTTTTTTXTTTTTTTTTT3TTTTTTTTTTTXTTTTTTTTT
TTTTTTTTTT3TTTTTTTTTTTTTTTTTTT1TTTTTZTTTTTZ2TTTT
TXTTTTTTTTTTTTTTTTTTTTTTTTTTTTTTTTTTXTTT13TTTX1T
TTTTTTTTTTTTTTTTTTTXXTTTTTTTTTTTTTTTTTXTTTTTTTTT
TTTTTTTTTTTTTTTTTTTTTTTTTTTTTTTTTXTTTTTTTTTTTTTT
TTTTXTTTTTTTTTTTTTTTTTXTT2TTTTXTTTTTTTTTTTTTTTTT
TTTTTTTTTTTT3TTTTTTTTTTTXTTTTTTTTTTTTTTTTTTTTXTX
TTTTTTTXTTTTTTT2TTTTTXTXTTTTTTTTTTXTTTTTTTTTTTZ3
TTT3TXTTTTTTTZTTTTTTTTT3TTTTTTT2TTTTXTTTTTTXTTTT
T1TTTTTTTTTTT2TTTTTTTTTTTTTTTTT1TTTTTXTTTTTTTTTT
TTTTTTTTTTTTT2TTTTTTTTT2TXXTXTTXTTTTTTTTTTTTTTTT
TTTT1TTTT2TTTTTTTTTTTTTTTTTTTTTTTTTTTTTTTTTTTTTT
TTTT3TTTTTTXTTTTTTTXTXTTTTTTTTTTTTTTTTTTT2TTT1TT
TTTTTTTTTZTTTTTTTTTTTTTTXTTTTTTTTTTTTTTTTTTTTTTT
TTTTTT2TTTTTTT3TTTTTTTTTXTTTTTTTTTTTTXT1TTTTTTTT
TZTTTTXTTTTTTTTTTTTTTTTTTTTTTTTTTTTTTTTTTTTTXTTT
TTTTTX21TXTTTTTTTTTTTTTTTTXTTTT2TTTTTTX1TTXTTXTT
3TTTTTTTTTTTTTTTTTTTTTTTTTTTTXTTTTXTTTTXTTTT3TTT
TT3TTTTTTTTTTTTTTTTTTT3TTTTTTTTTTTTZTTTTTTTTTXTT
TTXT3TTTTTTTTTTTTTTTTTTTTTT1TTTTTTTTT1TTTTXTTTTT
TTTTTXTTTTTTTTTTTTXTTTTTTTTTTTTTTTTTT2TTTTTTT1TX
TTXTTTTTTTTTTTTTXTTTTTTTXTTTTTTTTTTTTTZTTTTTTTTT
TTTTTTTTTTZTTTXTTXTTTTTTTXTTTTTTT3TTTTTTTTTTZT1T
TTT3T3TTTTTTTTTTTTTTTTTTTTTTT3TTT1TTTTTTTTTXT3TT
TTTTTTTTTTTTXTTTTTTTTTTTTTTTTTTTXTTTTTTTTTTTTTTT
TTTTTXTTTTTTTTTTTT1TTTTTTTT2TTTTTTTTXXTTTTTTZTTT
