W1TTXXXX
TXTT1TXT
TTTZ2XX1
TXTTTTTT
T1TTXZTX
TTZTT3TT
12TTTTT3
T1TXTZ1X
