WTTTTTTTTXTTTTTTTXTTTTTTTT3TTTTTTTTTTT3T
TTTTTTTTTXTT1TTTTTTTTTTTTTTTXTTTTTTTTX1T
XTXTTTTTTTTTTZTTTTTTTTTTTZTT1TXTTTTTTTTT
TTTTXTTTTTTTTTTTTTTTTTZTTTTTTTTTTTTTTTTT
TTTTTTTTTTXTTTTTTTTTTTTTTTTTTTTTTTTTTT32
XTTTTTTTT2TTTTT2TTTTTTTXTTTTTTTTTTTTTTTT
TTTTTTTXTT3TTTTTTTTTTTTTTTTXT1TTTTTTTTTT
TTTTTTTTTTTTTTTTTTTTTTTTTTTTTTTTTTTTTTTT
TTTTTTTTTXTTTTTTTTTTTTTTTTTTTTTTTTTTTT1T
TXTTTTTTTTTTTTTTTTTTTTTTTXTTTTTTTTTTTT2T
2TTTTTXZT2TXTTTTTTTTTTTTT1TT2TXTTTXTTTTT
TTXTTTTTZTTTXXTTXTTTTTTTTTTTTTTTTTTXTTTT
TTTTTTTTXXTTTX1TTTTTTT2TTTTTTTTTTTTTXTTT
TTTTTTTTTZTTTTTTTTTTTTTTTTTTTTTTTTTTTTTT
3TTTTTZTTTXTTTTT3TT2TTTTTTXTTXTTTTXTTTT2
TTTTT3T3TTTTTT3TTTXTTTTTTZTT3TTTTTTTTTXT
TTTTTTTTTTTTTT3TTTTTTTTTTTTT2XTTTTTTTXTT
TTTTTTTT2TTTTTTTTTTTTTTTXTTTTTTXTTTT2TTT
TTTXZTTTTTTTTTT1TTTTTTT23TTTTTTTTTTTTTTT
TTTTTXTTT2TTTTTTTTTTTTTTTTTTTTXTTXTTTTTT
3TTTTTTTTTTXT3TTTT3XTTTTTTT2XTTXTT3TTTTT
TTTTTTTTTTTTTTTXTTTTTTTTTT3TTT3TTTXTTTTX
TTTTTTTTTTTTTTTTTTXTTTTTTTTXTTZTTTTTTTTT
TTTTZTTTTTTXTTTTTTTTTTTTTTTTTTTTTTTTTTTT
TTXTTTTTTT2TTTTTXTTTTTTTTTTT3TTXTTTTTTTT
XTTTTTTTTTTTTTTTTTTTTTTTTTTTTTTTTTTTT1TT
TTTTTTTTTTTTTTTTTTTTTTTTTTTTTTTTTTTTTTTT
TTTXT1TXTTTTTTTTTTTTTTTTXTTTTTTTXTTTTTTT
TTTTTTXTTTTT1TTTTTTTTTTTTTTTTXT2TTTTTTTT
TTTTTTTTTTTTTTTTTTTTXTZTTXTTTTTXXTTT3TTZ
TTTT3TTTTTT3TTTTT1TTTTXTTTTTTTXTTXTTTTTT
TXTTTTTTTXTTTTTTTTTTXTTTTTTTTTXTTTTT3T1X
XTXTTT1TTXTTTX2TTTTTTTTXTTTTTTTTTTTTTTTT
TTTTTTTTTTTTTTTTZTTTTT3TTTTTTTTTTTTTTTXT
TTTTTTTTTTTTTTTTTTTTT1TXTTTTTTTTTTTTTTTT
TT3TT2TZ3ZTTTTTTTTTTTTXTTTTTTTTTZTTTTTTT
TTTTZTTTTTTTTTTTTTT1TTTTTTT1TTTTTTTXTTTT
1TTTTTTTTTTTTTTTTTTTXTT1TTTTTTTTTTTTT1TT
TTTXXTTTTTTTTTTTTTTTTTTTXT3TTTTTTTTTTTTT
TTTTTZXTTTXTTTTTTXTTTT1TTTTT3TTTX3TTTTXT
