WTTTXTTTTTXTTTTTTTTTTTTTTTT3T
TTTTTTTTTTTT2TTTTTTTTTTXTTTTT
TTTTTT3TTTTTX1TT3TZTTTTTTTT1T
TTTTTTXTTTXTTTT2TTTT2TTTTTTTT
T3TTZTT2TTT22TTTTTTTTTTTTTTXT
TTTTT2TXTTXTTTTTT3XTXTTTTT3TT
TTTTTTTTTTTXXTTTTZTTTTTT3TTTT
TTT3TTXTTXXTTTTTTXTT3TTTTTTTT
T1TTTTTTTTTTTTTTTTT3TTZTTTXTT
TTTTTTTTTTTTTTTTTTT2TTTTTTTTT
TTTTTTTTXTTT2TTTTTTTTTTXXTTTT
XTTTTTTT2TTTTTTXTTTTTTTTTTTTT
TTTTTTTTTTTTTTTTTTTTTTTTTXTXT
TXTTTTTZTTXTTTTTTTTTTTT1TTTX3
TTTTTTTTTTTTTTTTTTTTXTTZTTXT1
TTTTTXTTTTTTTTTTTTTTT3TXTTTTT
TTTXTTTTTTTTT1TXTTTTTTTTT3TTT
TT2TTTTTTXTTTTTTTTTXTTTTTT2TT
TTXTTTTTTT3TTTTTTTT13TTTTTTT2
TXTTTTTTTTTTTTTTTTTZTX1TTTTXT
XTTTTTTTTTTXTTXTTT32TZTTTTTTT
2TTTTTXTTTTXTTTTTTTTTXTTTTT3T
3TTTXTTTTTTTTTTTX1TTTTTTXTTTT
TTTTTTTTTTTTTTTTTTTTTTXT1TTTT
T1TTTTTTTTTTTTTTTTTTTTTZTTTTT
TTTTTTTTTXTTTTTTTTTTTTXTTTTTT
TTTTTTXT1TTTTTTTTTTXTTTTTTTTT
TTTTTTTTTTTTXTTTTTTTXTTTTT1TX
TTTTXTZTZTT3TXXTXTTTTXTTT1XTZ
