WTTT33TZTTX
TTXTTTXTTT2
TTTXTTX3XTT
TTTTTTTT1Z1
XZTTTTT3TT3
X2TTZTXTTTT
TTTTTTTTXXT
TTXTTZTTTXX
1TXT1TTTTTT
TTTT1TXTTXX
TTTTT2TTXXT
