WTZTTTTXTTT1TTTTTTTTTTT
TTTTTT1T3TZTTTTTTTTTTTT
TTTTTTTTTTTTTXTTTTTXTTT
XTTTTTZTTTXTTTTTTTXT1TT
TTTTTT2TTT1TTXTT3TTZTTT
TTTTTTTTTTTTTTTT3TTTTTX
TTT2TTXTT1TTXTTTTXTTTTT
T3TTTTTTTTTTTT2TXTTTXTT
XTTTTTTTZ1TTTTTTTTXTTTT
XTTTTTTXTTTTTTXTTTTTTTT
TTTTTXTTT112T1TTTTTTTTT
TTXTTTTTTTTTTXTTTTTTTTT
TTT2XT1TTT2XTTTTTTTTTTT
XTTT2XTTXTTTXTTTTTTTXT2
XXTTT3T2TTTZTTXTTZ1TX2T
1TTTTTTTTTTZTTTTTTTTTTT
XT1TTTZTTTTT3TTXTT2TT1T
TXTTXTTT11TTXTTTTTT1TTT
TTTTTTTXXT3ZT1T2TTTTTTT
TTTTTXXTXTTTXTTTTTXTTXT
TTTXTTTTTTTTTTTTTTTTTTT
T1TTTTTTTTTTTTTTTTTTTTT
XTTTTXTTTT2TTT2TXTTTTTT
