WTZXXXXXXXXXXXXXXXXXX
XTTTTTTTTTTTTTTTXTTTX
XXXXXXXXXXXTXXXTXTXTX
XTTTTTTTTTTTXTXTTTXTX
XXXXXXXXXXXXXTXXXXXTX
XTTTTTTTTTTTTTTTTTXTX
XTXTXXXXXXXTXXXXXXXTX
3TXTXTTTTTXTXTTTTTTTX
XXXTXXXXXTXTXTXXXXXXX
XTTTXTTTXTXTXTXTTTTTX
XTXTXTXTXTXTXTXTXXXTX
XTXTXTXTXTTTXTTTXTXTX
XTXXXTXTXXXTXXXXXTXTX
XTTTTTXTTTXTTTTTTTXTX
XXXXXXXXXTXXXXXXXTXTX
XTTTTTTTTTXTTTTTXTXTX
XTXXXXXXXXXTXXXTXXXTX
XTTTTTTTTTTTXTXTTTTTX
XTXXXXXXXXXXXTXXXXXXX
XTTTTTTTTTTTTTTTTTTTX
XXXXXXXXXXXXXXXXXXXXX
