WTZXXXXXXXXXXXXXXXXXXXXXXXXXXXXXXXXXXXXXX
XTTTTTTTTTXTTTTTTTTTTTTTTTTTTTTTXTTTTTTTX
XTXXXXXTXTXXXXXTXXXXXXXXXXXXXXXTXTXXXXXTX
XTXTTTXTXTTTTTTTXTTTTTTTTTTTTTXTXTXTTTTTX
XTXTXXXTXXXXXXXXXTXTXXXXXTXXXXXTXTXTXXXTX
XTXTTTTTTTTTTTTTXTXTXTTTXTXTTTTTXTXTXTXTX
XTXTXXXXXXXXXXXXXTXTXTXTXTXTXXXXXTXTXTXTX
XTXTXTTTTTTTTTTTXTXTXTXTXTXTXTTTXTXTXTXTX
XTXTXTXXXXXXXXXTXTXTXTXXXTXTXTXXXTXTXTXTX
XTXTXTXTXTTTTTXTXTXTXTTTTTXTXTTTTTXTXTXTX
XTXTXTXTXTXXXTXTXTXTXXXXXXXTXTXXXXXTXTXTX
XTXTXTXTTTXTTTXTXTXTXTTTTTTTXTXTTTXTXTTTX
XTXTXTXXXXXTXTXTXTXTXTXXXXXXXTXTXTXTXTXXX
XTXTXTTTTTTTXTXTXTXTTTXTTTTTXTXTXTXTXTTTX
XTXXXXXXXXXXXTXTXTXXXXXXXTXXXTXTXTXTXXXTX
XTTTTTTTTTTTXTXTTTXTTTTTXTXTTTXTXTXTXTXTX
XTXXXTXXXXXTXTXXXXXTXXXTXTXTXXXXXTXTXTXTX
XTXTXTXTTTXTXTTTTTXTXTTTXTTTTTTTTTXTXTTTX
XTXTXTXTXTXTXXXXXTXTXXXTXXXXXXXXXTXTXTXXX
XTXTXTXTXTXTXTTTXTXTTTXTTTTTTTTTXTXTXTTTX
XTXTXTXTXTXTXTXTXTXTXTXXXXXXXXXTXTXTXXXTX
XTTTXTXTXTTTTTXTXTXTXTXTTTTTTTXTXTXTXTTTX
XXXXXTXXXXXXXXXXXTXTXTXTXXXXXTXTXTXTXTXXX
XTTTTTXTTTTTTTTTTTXTXTXTXTTTTTXTXTXTXTXT3
XTXXXTXTXXXXXXXXXXXXXTXTXTXXXXXTXTXTXTXTX
XTXTTTXTXTTTTTTTTTTTTTXTXTXTTTTTXTXTXTTTX
XTXTXXXTXXXTXXXXXXXXXXXTXXXTXXXXXTXTXXXXX
XTXTTTXTXTTTXTTTXTTTTTTTTTTTXTTTTTXTTTTTX
XTXXXXXTXTXXXXXTXTXXXXXXXXXXXXXXXXXXXXXTX
XTTTTTXTXTXTTTTTXTXTTTXTTTTTTTTTTTTTTTTTX
XTXXXTXTXTXTXXXTXTXTXXXTXXXTXXXXXXXXXXXTX
XTTTXTXTXTXTXTXTXTXTTTTTXTXTXTTTTTXTTTXTX
XXXXXTXTXTXTXTXTXTXTXXXXXTXTXXXTXXXTXTXTX
XTTTTTXTXTXTXTTTXTXTTTTTTTXTTTXTTTTTXTXTX
XTXXXXXTXTXTXXXXXTXXXXXXXXXXXTXTXXXXXTXTX
XTTTXTTTXTXTTTTTTTXTTTTTTTTTTTXTTTTTXTXTX
XTXTXTXXXTXTXXXXXXXTXXXXXXXXXXXXXXXTXTXTX
XTXTTTXTTTXTTTTTXTTTXTTTTTTTTTXTTTTTXTXTX
XTXXXXXXXTXXXXXTXXXTXTXXXXXXXTXTXXXXXTXTX
XTTTTTTTTTXTTTTTTTTTXTTTTTTTXTTTTTTTXTTTX
XXXXXXXXXXXXXXXXXXXXXXXXXXXXXXXXXXXXXXXXX
