WTZXXXXXXXXXXXXXXXXXXXXXXXXXXXXXXXXXXXXXXXXXXXXXXXXXXXXXXXXXX
XTTTTTTTTTTTTTTTTTTTXTTTTTTTTTTTXTTTTTTTTTTTTTXTTTTTTTTTTTXTX
XTXXXXXXXXXTXXXXXXXTXTXXXXXXXTXTXXXXXTXXXXXXXTXTXXXXXXXTXTXTX
XTTTXTTTTTXTXTTTTTXTXTXTTTTTXTXTTTTTTTXTXTTTXTXTXTTTTTXTXTXTX
XXXTXTXXXTXTXTXXXTXTXTXTXXXTXTXXXXXXXXXTXTXTXTXTXXXXXTXTXTXTX
XTTTXTXTXTXTXTXTXTXTXTTTXTXTXTXTTTTTTTTTTTXTXTXTTTTTTTXTXTXTX
XTXXXTXTXTXTXTXTXTXTXXXXXTXTXTXTXXXXXXXXXXXTXTXXXXXXXXXTXTXTX
XTTTXTXTXTXTXTXTTTXTTTTTTTXTXTXTTTXTTTTTTTTTXTTTTTTTTTTTXTXTX
XXXTXTXTXTXTXTXXXXXXXTXXXXXTXTXXXTXTXXXXXXXXXXXXXXXXXXXXXTXTX
XTXTXTTTXTXTXTXTTTTTTTXTTTTTXTXTXTXTTTTTTTTTTTXTTTTTTTTTXTTTX
XTXTXXXXXTXTXTXTXXXXXXXTXXXXXTXTXTXXXXXXXXXXXTXTXXXXXXXTXXXTX
XTTTXTTTTTXTXTXTXTXTTTTTXTTTXTXTXTXTTTTTTTTTXTXTXTTTTTXTTTXTX
XTXXXTXXXXXTXTXTXTXTXXXXXXXTXTXTXTXTXXXXXXXTXTXTXTXXXTXTXXXTX
XTXTTTTTTTXTXTXTXTXTXTTTTTTTXTXTTTXTTTXTTTTTXTXTXTXTTTXTTTXTX
XTXXXXXTXTXTXTXTXTXTXTXXXXXTXTXTXXXTXTXXXXXXXTXTXTXTXXXXXTXTX
XTTTTTXTXTXTXTTTXTXTXTXTTTXTXTXTXTTTXTTTTTTTXTTTXTXTTTTTXTXTX
XXXXXTXTXTXTXTXXXTXTXTXTXTXTXTXTXXXXXXXXXXXTXXXXXXXXXXXTXTXTX
XTTTXTXTXTXTXTXTTTXTXTXTXTXTXTXTTTTTTTTTTTTTTTTTTTTTTTTTXTXTX
XTXXXTXTXTXTXTXTXTXTXTXTXTXTXTXXXXXXXXXXXXXXXXXXXXXTXXXXXTXTX
XTTTTTXTXTXTXTXTXTXTXTXTXTXTXTXTTTTTTTTTTTTTTTTTTTXTXTTTTTXTX
XTXXXXXXXTXTXTXXXTXTXTXTXXXTXTXTXXXXXXXXXXXXXXXXXXXTXTXXXXXTX
XTTTTTTTTTXTXTTTTTXTXTXTTTTTXTXTXTTTTTTTTTTTTTTTTTXTXTTTXTTTX
XXXXXXXXXXXTXXXXXXXTXTXXXXXXXTXTXTXXXXXXXXXXXXXXXTXTXXXTXTXXX
XTTTTTTTTTTTXTTTTTTTXTXTTTTTXTXTXTTTTTTTTTTTXTTTTTXTXTXTXTXTX
XTXXXXXXXXXTXTXXXXXXXTXTXXXTXTXTXXXXXXXXXXXTXTXXXXXTXTXTXTXTX
XTXTTTXTTTXTXTXTTTTTXTTTTTXTXTXTXTTTTTTTTTTTXTTTTTTTTTXTXTTTX
XTXXXTXTXTXTXTXTXTXTXXXXXXXTXTXTXTXXXXXTXXXXXXXXXXXXXXXTXXXTX
XTTTXTTTXTXTXTXTXTXTTTTTTTTTXTXTTTXTTTXTTTTTTTTTTTXTTTXTTTXTX
XTXTXXXTXTXTXTXTXTXXXXXXXXXTXTXXXXXTXTXXXXXXXXXXXTXTXTXTXTXTX
XTXTTTXTXTXTXTXTXTXTTTTTTTXTXTTTTTTTXTXTXTTTTTTTXTXTXTXTXTXTX
XTXXXTXTXTXTXTXTXTXTXTXXXXXTXXXXXXXXXTXTXTXXXTXTXTXTXTXTXTXTX
XTXTXTXTXTTTXTXTXTXTXTXTTTTTXTTTTTTTXTXTXTXTXTXTXTXTXTXTXTXTX
XTXTXTXTXXXXXTXTXTXTXTXTXXXXXTXXXXXTXTXTXTXTXTXXXTXTXTXTXTXTX
XTXTXTXTTTTTXTXTXTXTXTXTXTTTXTXTTTXTXTXTXTXTXTTTTTXTXTXTXTXTX
XTXTXTXXXXXTXTXXXTXTXXXTXXXTXTXTXTXTXTXTXTXTXXXXXXXTXTXTXTXTX
XTTTXTXTTTXTXTTTTTXTTTTTTTXTXTXTXTTTTTXTTTTTXTTTTTTTXTXTXTXTX
XXXXXTXTXXXTXXXXXTXXXXXXXTXTXTXXXXXXXXXXXXXXXTXXXXXXXTXXXTXTX
XTTTTTXTXTTTXTTTXTXTTTTTXTTTXTXTTTTTTTTTTTTTTTXTTTTTXTTTXTTTX
XTXXXXXTXTXXXXXTXTXTXXXTXXXXXTXTXXXXXXXXXXXXXXXTXXXTXXXTXTXXX
XTXTTTTTXTTTTTTTXTXTXTXTXTTTTTXTTTTTTTTTTTTTTTXTTTXTXTXTXTXTX
XTXTXTXXXXXXXXXTXTXTXTXTXTXXXTXXXXXXXXXXXXXXXTXTXTXTXTXTXTXTX
XTXTXTXTTTTTTTXTXTXTXTXTXTXTTTTTTTTTTTTTTTTTXTXTXTXTTTXTXTXTX
XTXTXTXTXXXXXTXTXTXTXTXTXTXXXXXXXXXXXXXXXXXTXTXTXTXXXTXTXTXTX
XTXTXTXTXTXTTTXTXTXTXTTTTTXTTTTTTTTTTTTTTTXTXTXTXTXTTTXTXTXTX
XTXXXTXTXTXTXXXTXTXTXXXXXXXTXXXXXXXXXXXXXTXTXTXTXTXTXXXTXTXTX
XTTTXTTTXTXTTTTTXTXTTTTTTTTTXTTTTTTTTTTTXTXTXTXTXTXTXTXTXTTTX
XTXTXTXXXTXXXXXXXTXXXXXXXXXXXTXXXXXXXXXXXTXXXTXTXTXTXTXTXXXTX
XTXTXTXTTTTTTTTTXTXTTTTTTTTTTTXTTTTTTTTTXTTTTTXTXTXTTTXTXTXTX
XTXTXTXXXTXTXTXXXTXTXXXXXTXXXTXTXXXXXXXTXXXXXXXXXTXTXXXTXTXTX
XTXTXTTTXTXTXTXTTTXTTTTTXTXTTTXTTTTTTTXTXTTTTTTTTTXTXTTTXTXTX
XXXTXXXTXXXTXTXTXXXXXXXTXTXXXXXXXXXXXTXTXTXTXXXXXXXTXTXXXTXTX
XTTTXTTTTTTTXTXTXTTTTTTTXTXTTTTTTTTTXTXTXTXTXTTTTTTTXTXTTTTTX
XTXXXXXTXXXXXXXTXTXXXXXXXTXTXXXXXTXTXTXTXTXTXXXXXXXXXTXTXXXXX
XTTTTTXTXTTTTTTTXTXTTTTTTTXTXTTTXTXTXTXTTTXTXTTTTTTTTTXTTTTTX
XXXXXTXTXTXXXXXXXXXTXXXXXXXTXTXTXTXXXTXXXXXTXTXXXXXTXXXXXXXXX
XTTTTTXTXTXTTTTTTTTTXTTTTTTTTTXTXTTTTTXTTTTTXTXTTTXTXTTTTTTTX
XTXXXXXTXTXTXTXXXXXXXTXXXXXXXXXXXXXXXTXTXXXTXTXTXXXTXTXXXXXTX
XTXTTTTTXTXTXTTTTTTTTTXTTTTTTTTTTTTTXTXTXTXTXTXTTTTTXTTTTTXTX
XTXXXXXXXTXXXXXXXXXXXXXTXXXXXXXXXXXTXXXTXTXTXTXXXXXXXTXXXXXTX
XTTTTTTTTTTTTTTTTTTTTTTTXTTTTTTTTTTTTTTTXTTTXTTTTTTTTTXTTTTTX
XXXXXXXXXXXXXXXXXXXXXXXXXXXXXXXXXXXXXXXXXXXXXXXXXXXXXXX3XXXXX
