WTZXXXXXXXXXXXXXXXXXXXXXXXXXXXXXXXXXXXXXXXXXXXXXXXXXXXXXXXXXXXXXXXXXXXXXXXXXXXXXX
XTTTXTTTTTTTTTTTTTTTTTTTTTTTTTTTTTTTTTTTTTTTTTTTTTTTTTTTTTTTXTTTTTTTTTTTTTTTTTTTX
XTXXXTXXXXXTXXXXXXXXXXXXXXXXXXXXXXXXXXXXXXXXXXXXXXXXXXXXXXXTXTXXXXXXXXXXXXXXXTXTX
XTTTTTXTTTXTXTTTTTTTTTXTTTTTXTTTTTTTTTTTTTTTTTTTTTTTXTTTTTXTXTTTTTTTTTTTTTTTXTXTX
XTXXXXXXXTXTXTXXXXXTXTXTXXXTXTXXXXXXXXXXXXXXXXXXXXXTXTXTXXXTXXXXXXXXXXXXXXXTXTXXX
XTXTTTTTTTXTXTXTTTXTXTXTXTXTXTXTTTTTTTTTTTTTTTTTTTTTXTXTTTTTXTTTTTXTTTTTTTXTXTTTX
XTXXXTXXXTXTXTXTXTXTXTXTXTXTXTXTXXXXXXXXXXXXXXXXXXXTXTXXXXXXXTXXXTXTXXXXXTXTXXXTX
XTTTXTXTXTXTXTTTXTXTXTXTXTXTXTXTXTTTTTTTXTTTTTTTTTXTXTTTTTTTXTXTTTTTXTTTXTXTXTXTX
XXXTXTXTXTXTXXXXXTXTXXXTXTXTXTXTXTXXXXXTXXXXXTXXXXXTXXXXXXXTXTXXXXXXXTXXXTXTXTXTX
XTXTXTXTXTXTXTTTTTXTTTTTTTXTXTXTXTXTTTTTTTTTTTXTTTTTTTTTTTXTXTTTTTTTXTTTTTXTXTXTX
XTXTXTXTXTXTXXXXXXXXXXXXXXXTXTXTXTXXXXXXXXXXXXXTXXXXXXXXXXXTXTXXXXXTXXXXXXXTXTXTX
XTXTXTXTTTXTXTTTTTTTTTTTTTTTXTXTXTTTTTTTTTTTTTTTXTTTTTTTTTTTXTTTTTXTTTTTTTTTTTXTX
XTXTXTXXXXXTXTXXXXXXXXXXXXXXXTXTXTXXXXXXXXXXXXXXXTXXXXXXXXXXXXXXXXXXXXXXXXXXXXXTX
XTXTXTTTTTXTXTTTTTTTTTTTTTTTTTXTXTXTTTTTTTTTTTTTXTXTTTTTTTTTTTTTTTTTTTTTTTTTTTTTX
XTXTXXXXXTXTXTXXXXXXXXXXXXXXXXXTXTXXXXXTXXXXXXXTXTXTXTXXXXXXXXXXXXXXXXXXXXXXXXXTX
XTTTTTTTTTXTXTXTTTTTTTTTTTXTTTXTXTTTTTTTXTTTTTTTXTXTXTXTTTTTTTTTTTTTTTTTXTTTTTTTX
XXXXXXXXXTXTXTXTXXXXXXXXXTXXXTXTXXXXXXXXXXXXXXXXXTXTXTXTXXXXXXXXXXXXXTXTXTXXXXXXX
XTTTXTTTXTXTXTTTXTTTTTTTTTTTTTXTXTTTTTTTTTTTTTTTTTXTXTXTTTTTXTTTTTTTTTXTXTXTXTTTX
XTXTXXXTXTXTXXXXXXXXXXXXXXXXXXXTXTXXXXXXXXXXXXXXXXXXXTXXXXXTXTXXXXXXXXXTXTXTXTXTX
XTXTTTXTXTXTXTTTTTTTTTTTTTTTTTTTXTTTTTTTTTTTTTTTTTTTTTXTTTTTXTXTTTXTTTXTXTXTTTXTX
XTXXXTXTXTXTXTXXXXXTXXXXXXXXXXXTXXXXXXXXXXXXXXXXXXXXXXXXXXXXXTXTXTXTXTXTXTXXXXXTX
XTXTXTXTXTXTXTXTTTXTXTTTXTTTTTTTXTTTTTTTTTTTTTTTXTTTTTTTTTTTXTXTXTXTXTXTXTXTTTTTX
XTXTXTXTXTXTXTXTXTXTXTXTXTXXXXXXXXXXXXXTXXXXXXXTXTXTXXXXXXXTXTXTXTXTXXXTXTXTXXXTX
XTXTXTXTXTXTXTXTXTTTXTXTXTTTTTTTTTTTTTTTXTTTTTXTXTXTXTXTTTXTTTXTXTTTXTTTXTXTXTTTX
XTXTXTXTXTXTXTXXXXXXXTXTXXXXXXXXXXXXXXXXXXXXXTXTXTXTXTXTXTXXXXXTXXXXXTXXXTXTXXXXX
XTXTXTXTXTXTXTTTTTTTTTXTXTTTTTTTTTTTTTTTTTTTTTXTXTXTXTTTXTTTXTTTTTTTTTXTTTXTTTTTX
XTXTXTXTXTXTXTXXXXXXXXXTXTXTXXXXXXXXXXXXXXXXXTXTXTXTXTXXXTXTXTXXXXXXXXXTXXXTXXXTX
XTXTTTXTTTXTXTXTTTTTTTXTXTXTTTTTXTTTTTTTTTTTTTXTXTXTXTXTXTXTXTXTTTTTTTXTXTXTTTXTX
XTXTXXXXXXXTXTXXXXXXXTXTXTXXXXXTXTXXXXXXXXXXXXXTXXXTXTXTXTXXXTXTXTXXXXXTXTXXXTXTX
XTXTTTTTTTTTXTTTTTTTXTXTXTXTTTXTXTXTTTTTXTTTTTTTXTTTXTXTXTTTTTXTXTTTTTXTXTTTTTXTX
XTXXXXXXXXXXXXXXXXXTXTXTXTXXXTXTXTXTXXXTXTXXXXXXXTXXXTXTXXXXXXXXXXXXXTXTXXXXXXXTX
XTXTTTTTTTXTTTTTTTXTXTXTXTTTTTXTXTXTTTXTXTXTTTTTTTXTXTXTTTTTTTTTTTTTTTXTTTTTTTTTX
XTXTXXXXXTXTXXXXXTXTXTXTXXXXXTXTXTXXXTXTXTXTXXXXXTXTXTXTXXXXXXXXXXXXXTXXXXXXXXXTX
XTXTTTTTXTXTXTTTXTXTXTXTXTTTXTXTXTXTTTXTXTXTTTTTXTXTXTXTTTXTTTTTTTTTXTXTTTTTTTXTX
XTXXXXXXXTXTXTXTXTXTXTXTXTXTXTXTXTXXXXXTXTXXXXXXXTXTXTXTXTXTXTXXXXXTXTXTXXXXXTXTX
XTXTTTTTTTXTXTXTXTXTXTXTXTXTXTXTXTXTTTTTXTTTTTTTTTXTXTXTXTXTXTXTTTXTXTTTXTXTTTXTX
XTXTXXXTXXXTXTXTXTXTXTXTXTXTXTXTXTXTXXXXXXXXXXXXXXXTXTXTXTXXXTXTXXXTXXXXXTXTXXXTX
XTXTXTXTXTTTXTXTXTXTXTXTXTXTXTXTXTXTXTTTTTTTTTTTTTXTXTXTXTXTTTXTTTTTTTTTTTXTTTXTX
XTXTXTXTXTXXXTXTXTXTXTXTXTXTXTXTXTXTXTXXXXXXXXXTXTXTXTXTXTXTXXXXXXXXXXXXXXXTXXXTX
XTXTXTTTXTXTTTXTXTXTXTXTXTXTTTXTXTTTXTTTXTTTTTXTXTXTXTXTXTXTTTTTTTTTTTTTTTTTXTTTX
XTXTXTXXXTXTXTXXXTXTXTXTXTXXXXXTXXXXXXXTXXXXXTXTXTXTXTXXXTXTXXXXXXXXXXXXXXXXXTXXX
XTXTXTXTTTXTXTXTTTXTXTXTXTTTTTXTTTTTTTTTTTTTTTXTXTTTXTTTXTXTXTTTTTTTTTTTTTTTXTTTX
XTXTXXXTXXXXXTXTXXXTXTXTXXXXXXXXXXXXXXXXXXXXXTXTXXXXXXXTXTXTXTXTXXXXXXXXXXXTXXXTX
XTXTTTTTXTTTTTXTTTTTTTXTXTTTTTTTTTTTTTTTTTTTXTXTTTTTTTTTTTXTXTXTXTTTTTTTTTXTXTXTX
XTXTXXXXXTXXXXXXXXXXXXXTXTXXXXXXXXXXXXXXXXXTXXXXXXXXXXXXXXXTXTXTXXXXXXXTXTXTXTXTX
XTXTXTTTTTTTTTTTXTTTXTTTXTTTTTXTTTTTTTTTTTXTXTTTTTTTTTTTTTXTXTXTTTTTTTXTXTTTTTXTX
XTXTXTXXXXXXXXXTXTXTXTXTXXXXXTXTXXXTXXXXXXXTXTXXXXXXXXXXXTXTXTXXXXXXXTXXXXXXXXXTX
XTXTXTXTTTTTXTXTXTXTXTXTXTTTXTXTTTXTXTTTTTTTXTXTTTTTTTTTXTXTXTTTTTTTXTXTTTTTTTTTX
XTXTXTXXXTXTXTXTXTXTXTXTXTXXXTXXXTXTXTXXXXXTXTXTXXXXXXXTXTXTXXXXXXXTXTXTXXXXXXXXX
XTXTXTTTXTXTTTXTTTXTXTXTXTXTTTXTTTXTXTXTTTXTXTXTTTTTTTXTXTXTXTTTTTTTXTXTXTTTTTTTX
XTXTXXXTXTXXXTXXXXXTXTXTXTXTXXXXXXXTXTXXXTXTXTXXXXXXXTXTXTXTXXXXXXXXXTXTXTXXXXXTX
XTXTXTTTTTXTTTXTTTXTXTXTXTXTTTTTTTTTXTXTTTXTXTTTTTTTXTXTXTXTTTTTTTTTTTXTXTTTTTXTX
XTXTXXXXXXXTXXXTXTXTXTXTXTXXXXXXXXXTXTXTXXXTXXXXXXXTXTXTXTXXXXXXXXXXXTXTXXXXXXXTX
XTXTTTTTXTTTTTXTXTXTXTXTXTTTTTTTTTXTXTXTXTTTXTTTTTXTXTXTXTXTTTTTTTTTXTXTTTTTTTTTX
XTXXXXXTXXXXXTXXXTXTXTXTXTXXXXXTXTXTXTXTXTXXXTXXXTXTXTXTXTXTXXXXXXXTXTXXXXXXXXXTX
XTXTTTTTTTTTXTTTTTXTXTXTXTXTTTXTXTXTXTXTXTXTTTXTXTXTXTXTXTXTXTTTTTTTXTXTTTTTTTXTX
XTXXXXXXXXXTXXXXXXXTXTXTXTXXXTXTXTXTXTXTXTXXXTXTXTXTXTXTXTXTXXXXXXXXXTXTXXXXXTXTX
XTTTTTTTTTXTTTTTTTTTXTXTXTTTXTXTXTXTXTXTXTTTTTXTXTXTXTXTXTXTTTTTTTTTTTXTTTTTXTXTX
XTXXXXXXXTXXXXXXXXXTXTXTXXXTXTXTXTXTXTXTXXXXXXXTXTXTXTXTXTXTXXXXXXXXXXXXXXXXXTXTX
XTTTXTTTXTXTTTTTTTTTXTXTXTXTTTXTXTXTXTXTTTTTTTTTXTXTXTXTXTXTXTTTTTTTTTTTTTTTTTXTX
XXXTXTXTXTXTXXXXXXXXXTXTXTXXXTXTXTXTXTXTXXXXXXXXXTXTXTXTXTXTXTXTXXXXXXXXXXXXXTXTX
XTTTXTXTXTXTTTTTTTTTXTXTXTTTXTXTXTXTXTXTTTTTTTTTTTXTXTXTXTXTXTXTXTXTTTTTTTXTXTXTX
XTXXXTXXXTXXXXXXXXXTXTXTXTXXXTXTXTXTXTXXXXXXXXXXXXXTXTXTXTXTXTXTXTXTXXXTXTXTXTXTX
XTXTTTTTXTXTTTTTTTXTXTXTXTTTTTXTXTXTXTXTTTTTTTTTTTTTXTXTXTXTXTXTXTXTXTXTXTTTXTXTX
XTXXXXXTXTXTXXXXXXXTXTXTXXXXXXXTXTXTXTXTXXXXXXXXXXXXXXXTXTXTXTXTXTXTXTXTXXXXXTXTX
XTTTTTTTXTXTTTTTTTTTXTXTTTTTTTTTXTXTXTXTXTTTTTTTTTTTTTTTXTXTXTXTXTXTTTXTTTTTTTXTX
XXXXXXXTXTXTXXXXXXXXXTXTXXXXXXXXXXXTXTXTXTXXXXXXXTXXXXXTXTXTXTXTXTXTXXXXXXXXXXXTX
XTTTTTXTXTXTXTTTTTTTXTXTXTTTTTTTTTTTXTXTXTXTTTTTXTXTTTTTXTXTXTXTXTXTXTTTTTTTTTTTX
XXXXXTXTXTXTXXXXXXXTXTXTXTXXXXXXXXXXXTXTXTXTXXXTXTXTXXXXXTXTXTXTXTXTXTXXXXXXXXXXX
XTTTTTXTXTXTTTTTTTTTXTXTXTXTTTTTTTTTXTXTXTTTXTTTXTXTXTTTXTXTXTXTXTTTXTXTTTTTTTTTX
XTXXXTXTXTXXXXXXXXXTXTXTXTXTXXXXXXXTXTXTXXXXXXXXXTXTXTXTXTXTXTXTXTXXXTXTXXXXXXXTX
XTXTTTXTXTTTXTTTTTXTXTXTXTXTXTTTTTTTXTTTTTTTTTTTTTXTXTXTXTXTXTXTXTXTXTXTXTTTTTXTX
XTXXXXXTXXXTXTXXXXXTXTXXXTXTXTXXXXXXXXXXXXXXXXXXXXXTXTXTXTXTXTXTXTXTXTXTXTXXXTXTX
XTTTTTXTXTXTXTTTTTTTXTTTTTTTXTXTTTTTTTTTXTTTTTTTTTXTXTXTXTXTXTXTXTXTXTXTXTXTTTXTX
XTXXXTXTXTXTXTXXXXXXXXXXXXXXXXXTXXXXXXXTXXXXXXXXXTXTXTXTXTXTXXXTXTXTXTXTXTXTXXXTX
XTTTXTXTXTXTXTXTTTTTTTTTTTXTTTTTXTTTTTXTXTTTTTTTTTXTXTXTXTXTTTTTXTTTXTXTXTXTTTXTX
XXXXXTXTXTXTXTXXXXXXXTXXXTXTXXXXXTXTXTXTXTXXXXXXXXXTXTXTXTXXXXXXXXXTXTXTXTXXXXXTX
XTTTTTXTXTXTXTTTTTTTTTXTTTXTXTTTTTXTXTXTXTTTTTTTTTTTXTXTXTXTTTTTTTXTXTXTXTTTTTTTX
XTXXXXXTXTXTXXXXXXXXXXXXXXXTXXXXXXXTXTXTXTXXXXXXXXXXXXXTXTXTXXXXXTXXXTXTXTXXXXXXX
XTTTTTTTTTXTTTTTTTTTTTTTTTTTTTTTTTTTXTXTXTTTTTTTTTTTTTTTXTTTTTTTXTTTTTTTXTTTTTTTX
XXXXXXXXXXXXXXXXXXXXXXXXXXXXXXXXXXXXXXXXXXXXXXXXXXXXXXX3XXXXXXXXXXXXXXXXXXXXXXXXX
