WTZXXXXXXXXXXXXXXXXXXXXXXXXXXXXXXXXXXXXXXXXXXXXXXXXXXXXXXXXXXXXXXXXXXXXXXXXXXXXXXXXXXXXXXXXXXXXXXXXXX
XTTTTTTTTTXTTTTTTTTTTTTTTTTTTTXTTTTTTTTTTTTTTTTTTTTTTTTTXTTTTTTTXTTTTTTTTTTTTTTTTTXTXTTTTTTTTTTTTTTTX
XTXXXXXXXTXTXXXXXXXXXXXTXXXXXTXTXXXXXXXXXXXXXXXXXTXXXXXTXTXXXXXXXTXXXTXXXXXXXXXXXTXTXTXXXXXXXTXXXXXTX
XTTTTTTTXTXTXTTTTTTTTTTTXTXTTTXTXTTTXTTTTTTTTTTTXTXTTTXTXTXTTTTTXTXTXTXTTTTTTTTTXTXTXTXTTTTTXTXTTTXTX
XXXXXXXTXTXTXTXXXXXXXXXXXTXTXXXTXTXTXXXTXXXXXXXTXTXTXXXTXTXTXXXTXTXTXTXTXXXXXXXTXTXTXTXTXTXTXTXTXTXTX
XTTTTTXTXTXTXTXTTTTTTTTTTTTTXTTTXTXTTTXTXTTTXTXTXTXTTTTTXTXTXTXTXTXTXTXTXTTTTTTTXTXTXTXTXTXTXTXTXTXTX
XTXXXTXTXTXTXTXTXXXXXXXXXXXXXTXXXTXXXTXTXTXTXTXTXTXXXXXXXTXTXTXTXTXTXTXTXTXXXXXXXTXTXTXTXTXTXTXTXTXTX
XTTTXTXTXTXTXTXTXTXTTTTTTTTTTTXTTTTTXTXTTTXTTTXTXTXTTTTTTTXTXTXTXTXTXTXTXTTTTTTTXTXTXTXTXTXTXTXTXTXTX
XXXXXTXTXTXTXTXTXTXTXXXXXXXXXXXTXXXTXTXXXTXXXXXTXTXTXXXXXXXTXTXTXTXTXTXTXXXXXXXXXTXTXTXXXTXTXTXTXTXTX
XTTTTTXTXTXTXTXTXTXTXTTTXTTTTTXTXTXTXTXTTTXTTTTTXTXTXTXTTTTTXTXTXTXTXTXTTTTTTTTTTTXTTTTTTTXTXTXTXTXTX
XTXXXXXTXTXTXTXTXTXTXTXXXTXTXTXTXTXTXTXXXTXTXTXXXTXTXTXTXXXXXTXTXTXTXTXTXXXXXXXXXXXXXXXXXXXXXTXTXTXTX
XTTTTTTTXTTTXTXTTTXTXTTTTTXTXTXTXTXTXTTTXTXTXTXTTTXTXTXTXTTTTTXTXTXTXTXTTTTTTTTTTTTTTTTTTTTTTTXTXTXTX
XTXXXXXXXXXXXTXXXXXTXTXXXXXTXTXTXTXTXXXTXXXTXTXTXXXTXTXTXTXXXTXTXTXTXTXXXXXXXXXXXXXXXXXXXXXXXXXXXTXTX
XTTTTTXTTTTTTTXTTTTTXTTTTTXTXTXTXTXTTTXTTTTTXTXTTTTTXTTTXTTTXTXTXTXTXTTTTTTTTTTTXTTTTTTTTTXTTTTTTTXTX
XXXXXTXTXXXXXTXTXXXXXXXXXTXTXTXTXTXXXTXXXXXXXXXXXXXXXTXXXXXXXTXTXTXTXXXXXXXXXXXTXTXXXTXXXTXTXTXXXTXTX
XTTTXTXTXTXTTTXTTTTTTTTTXTXTXTXTXTTTXTXTTTTTTTTTTTTTXTTTTTTTXTXTXTXTTTTTTTXTTTTTXTXTXTXTXTXTXTXTXTXTX
XTXTXTXTXTXTXXXXXXXXXXXTXTXTXXXTXTXTXTXTXXXXXXXXXXXTXXXXXXXTXTXTXTXXXXXXXTXTXXXXXTXTXTXTXTXTXTXTXTXTX
XTXTXTXTXTXTXTTTTTTTTTXTXTXTTTTTTTXTXTTTTTTTTTTTTTXTTTTTTTTTTTXTTTTTTTTTTTXTXTTTTTXTXTXTTTXTXTXTTTXTX
XTXTXTXTXTXTXXXXXXXXXTXTXXXXXXXXXXXXXXXXXXXXXXXXXXXXXXXXXXXXXXXXXXXXXXXXXXXTXTXXXXXTXTXXXXXTXTXXXXXTX
XTXTXTXTXTXTTTTTTTTTTTXTTTTTTTTTTTTTTTTTTTTTTTTTTTTTTTTTTTTTTTTTTTTTTTTTTTTTXTTTTTTTXTXTTTTTXTTTTTTTX
XTXTXTXTXTXXXXXXXXXXXTXXXXXXXXXXXXXXXXXXXXXXXXXXXXXXXXXXXXXXXXXXXXXXXXXXXXXXXXXXXXXXXTXTXXXXXXXXXXXXX
XTXTXTXTXTTTTTXTTTTTTTXTTTTTTTTTTTTTTTTTTTTTXTTTTTTTXTTTTTTTTTTTTTTTTTXTTTTTTTTTTTTTTTXTXTTTTTXTTTTTX
XXXTXTXTXTXXXTXTXXXXXXXXXXXXXXXXXXXXXTXXXXXTXTXXXTXXXTXXXTXXXTXXXXXXXXXTXXXXXTXXXXXXXXXTXTXXXTXTXXXTX
XTTTXTXTXTTTXTXTXTTTTTTTTTTTTTTTTTTTXTXTTTXTXTTTXTXTTTXTXTXTTTXTTTTTTTTTXTTTXTTTTTTTTTTTXTXTXTXTXTXTX
XTXTXTXTXXXXXTXTXTXTXXXXXXXXXXXXXXXTXTXTXXXTXXXXXTXTXXXTXTXXXXXTXXXXXXXXXXXTXXXXXXXXXXXXXTXTXTXTXTXTX
XTXTXTXTXTTTTTXTXTXTXTTTTTTTTTTTTTXTXTXTTTTTTTTTTTXTXTTTXTTTTTTTXTTTTTTTTTTTXTTTTTXTTTTTXTXTXTXTXTXTX
XTXTXTXTXTXXXXXTXTXTXTXXXXXXXTXXXTXTXTXXXXXXXXXXXXXTXTXTXXXXXXXXXTXXXTXXXXXTXTXTXTXTXXXTXTXTXTXTXTXTX
XTXTXTXTXTXTTTXTXTXTXTTTTTTTXTXTXTXTXTXTTTTTTTTTTTTTXTXTTTTTTTTTXTXTXTXTTTTTXTXTXTXTXTXTXTXTXTXTXTXTX
XTXTXTXTXTXTXTXTXTXTXXXTXXXXXTXTXTXTXTXTXXXXXXXXXXXXXTXXXXXXXXXXXTXTXTXTXXXXXTXTXTXTXTXTXTXTXTXTXTXTX
XTXTXTXTXTXTXTXTXTXTXTXTXTTTXTXTXTXTXTXTXTTTTTTTTTTTXTTTTTTTTTTTTTXTXTXTXTTTXTXTXTXTXTXTXTXTXTXTXTXTX
XTXTXTXTXTXTXTXTXTXTXTXTXTXTXTXTXTXTXTXTXTXXXXXXXXXXXTXXXXXXXXXXXXXTXTXTXXXTXTXTXXXTXTXTXTXTXTXTXTXTX
XTXTXTXTXTXTXTXTXTXTXTTTXTXTXTXTXTXTXTXTXTTTTTTTTTTTTTXTTTTTTTTTTTTTXTXTTTTTXTXTTTTTXTXTXTXTXTTTXTXTX
XTXXXTXTXTXTXTXTXXXTXTXXXTXTXTXTXTXTXTXTXTXXXXXXXXXXXXXTXXXXXXXXXTXXXTXXXXXTXTXXXXXXXTXTXTXTXXXXXTXTX
XTTTTTXTXTTTXTTTTTTTXTTTXTXTXTXTTTXTXTXTXTXTTTTTTTTTXTTTTTTTTTTTXTTTXTXTTTXTXTTTTTTTTTXTTTXTTTTTTTXTX
XTXXXXXTXXXXXXXXXXXXXXXXXTXTXTXTXXXTXTXTXTXTXXXXXTXTXXXXXXXXXXXXXXXTXTXTXXXTXTXXXXXXXXXXXTXXXXXTXTXTX
XTXTTTXTTTTTTTTTTTTTTTTTTTXTXTXTTTXTXTXTXTXTTTTTXTXTXTTTTTTTTTTTTTTTXTXTTTTTXTXTTTTTTTTTXTTTTTTTXTXTX
XTXXXTXXXXXXXXXXXXXXXXXXXXXTXTXXXXXTXTXTXTXXXXXXXTXTXTXXXXXXXXXXXXXTXTXXXXXXXTXTXXXXXXXTXXXXXXXXXXXTX
XTTTTTTTTTTTTTTTTTTTTTTTTTXTXTTTTTTTXTXTXTTTTTTTTTXTTTXTTTTTTTTTTTTTXTTTTTTTTTXTXTTTTTXTTTTTTTTTTTTTX
XXXXXXXXXXXXXXXXXXXXXXXXXTXTXTXXXXXXXTXTXXXXXXXXXXXXXXXXXXXXXXXXXXXXXXXXXXXXXXXTXTXXXTXXXXXXXXXXXXXTX
XTTTTTTTTTTTTTTTTTTTXTTTTTXTXTTTTTTTTTXTTTTTTTTTTTTTTTTTTTTTTTTTTTTTTTTTTTTTTTTTXTXTXTTTTTTTTTTTTTXTX
XTXXXXXXXXXXXXXXXXXTXTXXXXXTXXXXXXXXXXXXXXXXXXXXXXXXXXXXXXXXXXXXXXXXXXXXXXXXXXXXXTXTXTXXXXXXXXXXXTXTX
XTXTTTTTTTTTTTTTTTXTXTTTTTXTTTTTTTTTTTTTTTTTTTXTTTTTTTXTTTTTTTTTTTTTTTTTTTTTTTTTXTXTXTXTTTTTTTTTXTXTX
XTXTXXXXXXXXXXXTXXXTXXXXXXXTXXXXXXXXXXXXXXXXXTXTXXXXXTXTXXXXXXXXXXXXXTXXXXXXXXXTXTXTXTXTXXXTXXXXXTXTX
XTXTTTTTTTTTTTXTTTTTTTTTTTXTXTXTTTTTTTTTTTTTXTXTXTTTXTTTXTTTTTTTTTTTTTXTTTXTTTTTXTXTXTXTXTXTTTTTTTXTX
XTXXXXXXXXXXXXXXXXXXXXXXXTXTXTXTXTXXXXXXXXXTXTXTXXXTXXXXXTXXXXXXXXXXXXXXXTXTXXXXXTXTXTXTXTXXXXXXXXXTX
XTTTTTTTTTTTTTTTTTTTXTTTXTXTXTTTXTXTTTTTTTTTXTTTTTTTTTTTXTXTTTXTTTTTTTTTTTXTXTTTXTXTXTXTTTTTTTTTXTTTX
XTXXXXXXXXXXXXXXXXXTXTXTXTXTXXXXXTXXXXXXXXXXXXXXXXXXXXXXXTXTXTXTXTXXXXXXXXXTXXXTXTXTXTXXXXXXXXXTXTXXX
XTXTTTTTTTTTTTTTTTXTXTXTXTXTTTTTTTXTTTTTTTTTTTTTTTTTTTTTTTXTXTXTXTTTTTTTTTTTTTTTXTXTXTXTTTTTTTXTXTTTX
XTXXXXXXXXXXXXXTXTXTXTXXXTXXXXXXXXXTXXXXXXXXXXXXXXXXXXXXXXXXXTXTXXXXXXXXXXXXXXXXXTXTXTXTXXXXXTXTXXXTX
XTTTTTTTTTTTTTTTXTXTXTTTTTTTTTTTTTTTXTTTTTTTXTTTTTTTTTTTTTTTTTXTXTTTTTXTTTTTTTTTTTXTXTXTTTTTXTXTXTXTX
XXXXXXXXXXXXXXXXXTXTXTXXXXXXXXXXXXXXXTXXXXXTXTXTXXXXXXXXXXXXXTXTXXXXXTXTXXXXXXXXXXXTXTXXXXXTXTXTXTXTX
XTTTTTTTTTTTTTTTTTXTXTXTXTTTTTTTTTXTTTXTXTTTXTXTXTTTTTTTTTTTXTXTTTTTTTXTXTTTTTTTTTTTXTXTTTXTXTXTXTXTX
XTXXXXXXXXXXXXXXXXXTXTXTXTXXXXXXXTXTXTXTXTXXXXXTXTXXXXXXXXXTXTXTXXXXXXXTXXXXXXXXXTXTXTXTXTXTXTXTXTXTX
XTXTTTTTTTTTTTTTTTXTXTTTXTXTTTTTXTXTXTXTTTTTTTTTXTXTTTTTTTXTXTXTXTTTTTTTTTTTTTTTTTXTXTXTXTXTXTTTXTXTX
XTXTXXXTXXXXXXXXXTXTXXXTXTXTXTXTXTXTXTXXXXXXXXXXXTXTXXXXXTXTXXXTXTXXXXXXXXXXXXXXXXXXXTXXXTXTXXXXXTXTX
XTXTXTXTXTTTXTTTTTXTXTXTXTXTXTXTXTXTXTTTTTTTTTTTTTXTTTTTXTXTTTTTXTXTXTTTTTTTTTTTTTTTTTXTTTXTXTTTTTXTX
XTXTXTXTXTXTXTXXXXXTXTXTXTXTXTXTXTXTXXXXXXXXXXXXXXXXXXXXXTXXXXXXXTXTXTXXXXXXXXXXXXXXXXXTXXXTXTXXXTXTX
XTXTTTXTXTXTXTTTTTXTXTTTXTXTXTXTXTXTTTTTTTTTTTXTTTTTTTTTXTXTTTTTTTXTXTXTTTTTTTTTTTTTTTTTXTTTXTXTXTXTX
XTXXXXXTXTXTXXXXXTXTXXXXXTXTXTXTXTXXXXXXXXXXXTXTXXXXXXXTXTXTXXXXXXXTXTXTXXXXXXXXXXXTXXXTXTXXXTXTXTXTX
XTTTTTTTXTXTXTTTXTXTTTTTTTXTXTXTXTXTTTTTTTTTXTXTTTXTTTXTXTXTXTTTTTTTXTXTTTTTXTXTTTXTXTTTXTTTXTTTXTXTX
XXXXXXXXXTXTXXXTXTXXXXXXXXXXXTXXXTXTXXXXXXXTXTXTXTXTXTXTXTXTXTXXXTXTXTXXXXXTXTXTXTXTXXXXXXXTXXXTXTXTX
XTTTTTTTTTXTTTTTXTTTTTTTTTTTXTTTXTXTXTTTTTXTXTXTXTXTXTTTXTXTXTXTXTXTXTXTTTXTXTXTXTXTXTTTTTTTXTXTXTXTX
XTXTXXXXXXXXXXXXXXXXXXXXXXXTXTXTXTXTXTXXXXXTXTXXXTXXXXXTXTXTXTXTXTXTXTXTXTXTXTXTXTXTXTXXXXXXXTXTXTXTX
XTXTXTTTTTTTTTTTTTTTTTTTTTTTXTXTXTXTXTTTTTTTXTXTTTXTTTXTTTXTXTXTXTXTXTXTXTXTXTXTXTXTXTXTTTTTTTXTXTXTX
XTXTXTXXXXXXXXXXXXXXXXXXXXXXXXXTXTXTXXXXXXXXXTXTXXXTXTXXXTXTXTXTXTXTXTXTXTXTXTXTXTXTXTXTXXXTXTXTXTXTX
XTXTXTXTTTTTTTTTTTTTTTTTTTTTTTTTXTXTXTTTTTTTTTXTTTXTXTXTTTXTXTTTXTXTXTXTXTXTXTTTXTXTXTXTXTXTXTXTXTXTX
XTXTXTXXXXXXXXXTXXXXXXXXXXXXXXXTXTXTXTXXXXXXXXXXXTXTXTXXXXXTXXXXXTXXXTXTXXXTXTXXXTXTXTXTXTXTXTXTXTXTX
XTXTXTTTTTTTTTTTXTTTTTTTTTXTTTXTXTXTXTXTTTXTTTTTTTXTXTXTTTTTTTTTTTXTTTXTTTTTXTTTXTXTXTXTTTXTXTXTXTXTX
XTXTXXXXXXXXXXXXXTXXXTXXXXXTXTXTXTXTXTXTXXXTXTXXXXXTXTXTXXXXXXXXXXXTXXXTXXXXXXXXXTXTXTXXXXXTXTXTXTXTX
XTXTTTTTTTTTTTTTTTXTXTTTTTTTXTXTXTXTTTXTTTTTXTXTTTTTXTTTXTXTTTTTTTTTXTTTTTTTTTTTTTXTXTXTTTTTXTXTXTXTX
XTXXXXXXXXXXXXXXXXXTXXXXXXXXXTXTXTXTXXXXXXXXXTXTXXXXXXXXXTXTXXXXXXXXXXXXXXXXXXXXXXXTXTXTXXXXXXXTXTXTX
XTXTTTTTTTTTTTTTTTTTTTTTTTTTXTXTXTXTTTTTTTTTTTXTXTTTTTTTTTXTTTTTTTTTTTTTTTTTTTTTTTXTXTXTTTTTTTTTXTXTX
XTXXXXXXXXXXXXXXXXXXXXXTXXXXXTXTXTXXXXXXXXXXXTXTXTXTXXXXXTXXXXXXXXXXXXXXXXXXXXXXXTXTXTXXXXXXXXXXXTXTX
XTTTTTTTTTTTTTTTTTTTTTTTXTTTTTXTXTXTTTTTTTTTTTXTXTXTXTTTTTXTTTTTTTXTTTTTTTTTTTTTXTXTXTXTTTTTTTTTTTXTX
XXXXXXXXXXXXXXXXXXXXXXXTXTXXXTXTXTXTXXXXXXXXXXXTXTXTXTXXXXXTXTXTXXXTXTXXXXXXXXXTXTXTXTXTXXXXXXXXXXXTX
XTXTTTTTTTXTTTTTTTTTTTXTXTXTTTXTXTXTXTTTTTTTXTTTXTXTXTXTTTXTXTXTXTTTXTTTTTXTTTXTXTXTXTXTXTTTTTTTTTTTX
XTXTXXXXXTXTXXXXXXXXXTXTXTXXXXXTXTXTXXXXXXXTXTXXXXXTXTXTXTXTXTXTXTXXXXXXXTXTXTXTXTXTXTXTXTXXXXXXXXXXX
XTXTXTTTXTXTXTTTTTTTXTXTXTTTTTTTXTXTTTTTTTTTXTTTTTTTXTXTXTXTXTXTXTXTTTTTXTXTXTXTXTXTXTXTXTXTTTTTTTTTX
XTXTXXXTXTXTXXXXXXXTXTXTXXXXXXXXXTXXXXXXXXXTXXXXXXXXXTXTXTXTXTXXXTXTXXXTXTXXXTXTXTXTXTXTXTXTXXXXXXXTX
XTTTTTTTXTTTTTTTTTTTXTXTXTTTTTTTXTXTTTTTTTXTXTTTTTTTXTXTXTXTXTXTTTXTTTXTXTTTXTXTXTXTXTXTXTXTXTTTTTXTX
XXXXXXXXXXXXXXXXXXXXXTXTXTXTXXXTXTXTXXXXXTXTXTXTXTXXXTXTXXXTXTXTXXXXXXXTXXXTXTXTXTXTXTXTXTXTXTXTXTXTX
XTTTTTTTTTTTTTTTTTTTTTXTXTXTXTXTXTXTXTTTXTXTXTXTXTXTTTXTTTTTXTTTTTTTTTTTTTXTXTTTXTXTTTTTXTXTXTXTXTXTX
XTXXXXXXXXXXXXXXXXXXXTXTXTXTXTXTXTXTXTXXXTXTXTXTXTXTXXXXXXXXXXXXXXXXXXXXXXXTXXXXXTXXXXXXXTXTXTXTXTXTX
XTXTTTXTTTTTTTTTTTTTTTXTXTXTXTXTXTXTXTTTTTXTXTXTXTXTXTTTTTTTTTTTTTTTTTTTTTXTTTTTXTTTTTTTTTXTXTXTXTXTX
XTXXXTXTXXXXXXXXXXXXXXXTXTXTXTXTXTXTXTXXXXXTXTXTXTXTXXXTXXXXXXXXXXXXXXXXXTXTXXXTXXXXXXXXXXXTXTXTXXXTX
XTXTTTXTXTTTTTTTTTTTXTTTXTXTXTXTXTXTXTTTXTTTXTXTXTXTTTXTXTTTTTTTTTTTTTXTTTXTXTXTTTTTTTTTTTTTXTXTXTTTX
XTXTXXXTXXXXXXXXXXXTXTXXXTXTXTXTXTXTXXXXXTXXXXXTXXXXXTXTXTXXXXXXXTXXXXXTXXXTXTXTXXXXXXXXXXXXXXXTXTXXX
XTXTTTTTTTTTTTTTTTTTXTXTXTXTXTTTXTXTTTTTTTTTTTTTXTTTXTXTXTXTTTTTXTTTTTXTXTXTXTXTXTTTXTTTTTTTTTTTXTXTX
XTXXXXXXXXXXXXXXXXXXXTXTXTXTXXXXXTXTXXXXXXXXXXXXXTXTXTXTXTXTXXXXXXXXXTXTXTXTXTXTXTXTXXXXXXXTXXXTXTXTX
XTTTTTTTTTTTTTTTTTTTTTXTXTXTTTTTXTXTXTTTTTTTTTTTTTXTXTXTXTXTXTTTTTTTXTXTXTXTXTXTXTXTTTTTTTTTXTXTXTXTX
XTXXXXXXXXXXXXXXXXXXXXXTXTXXXXXTXTXTXTXXXXXXXXXXXXXTXTXTXTXTXTXXXXXTXTXTXTXTXTXTXTXXXXXXXXXXXTXTXTXTX
XTXTTTTTTTTTTTTTXTTTTTTTXTXTXTTTXTXTXTXTXTTTTTTTTTXTXTXTXTTTXTXTTTXTXTXTXTTTTTXTXTTTTTTTTTXTTTXTXTXTX
XTXXXXXXXTXXXXXTXTXXXXXTXTXTXTXTXTXTXTXTXTXXXXXTXXXTXTXTXXXXXTXXXTXTXTXTXXXXXXXTXTXXXXXXXTXTXTXTXTXTX
XTTTTTTTTTXTTTXTXTXTTTTTXTXTXTXTXTXTXTXTXTXTTTXTXTTTXTXTTTTTTTTTTTXTXTXTXTTTTTTTXTTTTTTTXTXTXTXTXTXTX
XXXXXXXXXXXTXTXTXTXXXXXXXTXTXTXTXTXXXTXTXTXTXTXTXTXTXTXTXXXXXXXXXXXTXTXTXTXXXXXXXXXXXXXXXTXTXXXTXTXTX
XTTTTTTTTTXTXTXTXTTTTTTTTTTTXTXTXTTTTTXTTTTTXTXTXTXTXTXTXTTTTTTTTTTTXTXTXTXTTTTTTTTTTTTTTTXTTTTTXTXTX
XTXXXXXXXTXTXTXTXXXXXXXXXXXXXTXTXXXXXXXXXXXXXXXTXTXTXTXTXTXXXXXXXXXXXTXTXTXTXXXTXXXXXXXXXXXXXXXXXTXTX
XTXTTTTTXTXTXTXTTTTTTTTTTTTTTTXTTTTTTTTTTTTTTTTTXTXTXTXTXTXTXTTTTTTTTTXTXTXTXTTTXTTTTTTTTTTTTTTTTTXTX
XTXXXXXTXTXTXTXXXXXXXXXXXXXXXXXXXXXXXXXXXXXXXXXTXTXXXTXXXTXTXTXTXXXXXXXTXTXTXXXXXTXXXXXXXXXXXXXXXXXTX
XTTTTTTTXTTTXTTTTTTTTTTTTTTTTTTTTTTTTTTTTTTTTTTTXTTTTTTTTTXTTTXTTTTTTTTTTTXTTTTTTTTTTTTTTTTTTTTTTTTTX
XXXXXXX3XXXXXXXXXXXXXXXXXXXXXXXXXXXXXXXXXXXXXXXXXXXXXXXXXXXXXXXXXXXXXXXXXXXXXXXXXXXXXXXXXXXXXXXXXXXXX
